ACT Symbol	# Company Name
A	# "Agilent Technologies
AA	# Alcoa Inc. Common Stock
AA$B	# Alcoa Inc. Depository Shares Representing 1/10th Preferred Convertilble Class B Series 1
AAC	# "AAC Holdings
AAN	# "Aaron's
AAP	# Advance Auto Parts Inc Advance Auto Parts Inc W/I
AAT	# "American Assets Trust
AAV	# Advantage Oil & Gas Ltd  Ordinary Shares
AB	# Allianceberstein Holding L.P.  Units
ABB	# ABB Ltd Common Stock
ABBV	# AbbVie Inc. Common Stock
ABC	# AmerisourceBergen Corporation (Holding Co) Common Stock
ABEV	# Ambev S.A. American Depositary Shares (Each representing 1 Common Share)
ABG	# Asbury Automotive Group Inc Common Stock
ABM	# ABM Industries Incorporated Common Stock
ABR	# Arbor Realty Trust Common Stock
ABR$A	# Arbor Realty Trust Preferred Series A
ABR$B	# Arbor Realty Trust Cumulative Redeemable Preferred Series B
ABR$C	# Arbor Realty Trust Cumulative Redeemable Preferred Series C
ABRN	# Arbor Realty Trust 7.375% Senior Notes due 2021
ABT	# Abbott Laboratories Common Stock
ABX	# Barrick Gold Corporation Common Stock
ACC	# American Campus Communities Inc Common Stock
ACCO	# Acco Brands Corporation Common Stock
ACE	# Ace Limited Common Stock
ACG	# Alliancebernstein Income Fund
ACH	# Aluminum Corporation of China Limited American Depositary Shares
ACI	# "Arch Coal
ACM	# AECOM Common Stock
ACMP	# "Access Midstream Partners
ACN	# Accenture plc. Class A Ordinary Shares (Ireland)
ACP	# Avenue Income Credit Strategies Fund Common Shares
ACRE	# Ares Commercial Real Estate Corporation Common Stock
ACT	# Actavis plc Ordinary Shares
ACW	# Accuride Corporation Common Stock
ADC	# Agree Realty Corporation Common Stock
ADM	# Archer
ADPT	# Adeptus Health Inc. Common Stock
ADS	# Alliance Data Systems Corporation Common Stock
ADT	# ADT Corporation Common Stock
ADX	# Adams Express Company (The)
AEB	# AEGON N.V. Perp. Cap. Secs. Floating Rate (Netherlands)
AEC	# Associated Estates Realty Corporation Common Stock
AED	# AEGON N.V. Perp. Cap. Securities (Netherlands)
AEE	# Ameren Corporation Common Stock
AEG	# AEGON N.V. Common Stock
AEH	# AEGON N.V. Perp. Cap Secs.
AEK	# Aegon NV 8.00% Non
AEL	# American Equity Investment Life Holding Company Common Stock
AEM	# Agnico Eagle Mines Limited Common Stock
AEO	# "American Eagle Outfitters
AEP	# "American Electric Power Company
AER	# Aercap Holdings N.V. Ordinary Shares
AES	# The AES Corporation Common Stock
AES$C	# AES Corporation (The) Class C Preferred Stock
AET	# Aetna Inc. Common Stock
AF	# Astoria Financial Corporation Common Stock
AF$C	# Astoria Financial Corporation Depositary Shs Repstg 1/40th Int Perp Pfd Ser C 6.5%
AFA	# "American Financial Group
AFB	# AllianceBernstein National Municipal Income Fund Inc
AFC	# "Allied Capital Corporation Allied Capital Corporation 6.875% Notes due April 15
AFG	# "American Financial Group
AFGE	# "American Financial Group
AFL	# AFLAC Incorporated Common Stock
AFM	# "Affiliated Managers Group
AFQ	# "American Financial Group
AFSD	# "Aflac Incorporated 5.50% Subordinated Debentures due September 15
AFSI$A	# "AmTrust Financial Services
AFSI$B	# "AmTrust Financial Services
AFSI$C	# "AmTrust Financial Services
AFT	# Apollo Senior Floating Rate Fund Inc. Common Stock
AFW	# "American Financial Group
AG	# First Majestic Silver Corp. Ordinary Shares (Canada)
AGC	# Advent Claymore Convertible Securities and Income Fund Common Shares of Beneficial Interest
AGCO	# AGCO Corporation Common Stock
AGD	# Alpine Global Dynamic Dividend Fund Shares of Beneficial Interest
AGI	# Alamos Gold Inc Ordinary Shares
AGM	# Federal Agricultural Mortgage Corporation Common Stock
AGM$A	# Federal Agricultural Mortgage Corporation 5.875% Non
AGM$B	# Federal Agricultural Mortgage Corporation Non Cumulative Preferred Stock Series B
AGM$C	# Federal Agricultural Mortgage Corporation Preferred Series C Fixed to Fltg
AGM.A	# Federal Agricultural Mortgage Corporation Common Stock
AGN	# "Allergan
AGO	# Assured Guaranty Ltd. Common Stock
AGO$B	# Assured Guaranty Ltd.
AGO$E	# Assured Guaranty Ltd.
AGO$F	# Assured Guaranty Ltd.
AGRO	# Adecoagro S.A. Common Shares
AGU	# Agrium Inc. Common Stock
AGX	# "Argan
AHC	# A.H. Belo Corporation Common Stock
AHH	# "Armada Hoffler Properties
AHL	# Aspen Insurance Holdings Limited Ordinary Shares
AHL$A	# Aspen Insurance Holdings Limited Perp Pfd Shares (Bermuda)
AHL$B	# Aspen Insurance Holdings Limited Perp Pref Shs (Bermuda)
AHL$C	# Aspen Insurance Holdings Limited 5.95% Fixed
AHP	# "Ashford Hospitality Prime
AHS	# AMN Healthcare Services Inc AMN Healthcare Services Inc
AHT	# Ashford Hospitality Trust Inc Common Stock
AHT$A	# Ashford Hospitality Trust Inc 8.55% Cum Preferred Series A
AHT$D	# Ashford Hospitality Trust Inc 8.45% Series D Cumulative Preferred Stock
AHT$E	# Ashford Hospitality Trust Inc 9.00% Series E Cumulative Preferred Stock
AI	# Arlington Asset Investment Corp Class A (new)
AIB	# Apollo Investment Corporation 6.625% Senior Notes due 2042
AIF	# Apollo Tactical Income Fund Inc. Common Stock
AIG	# "American International Group
AIG.W	# "American International Group
AIN	# Albany International Corporation Common Stock
AIR	# AAR Corp. Common Stock
AIT	# "Applied Industrial Technologies
AIV	# Apartment Investment and Management Company Common Stock
AIV$A	# Apartment Investment and Management Company Preferred Series Class A
AIV$Z	# Apartment Investment and Management Company Class Z Cumulative Preferred Stock
AIW	# Arlington Asset Investment Corp 6.625% Notes due 2023
AIY	# Apollo Investment Corporation 6.875% Senior Notes due 2043
AIZ	# "Assurant
AJG	# Arthur J. Gallagher & Co. Common Stock
AKO.A	# Embotelladora Andina S.A. Common Stock
AKO.B	# Embotelladora Andina S.A. Common Stock
AKP	# Alliance California Municipal Income Fund Inc
AKR	# Acadia Realty Trust Common Stock
AKS	# AK Steel Holding Corporation Common Stock
AL	# Air Lease Corporation Class A Common Stock
ALB	# Albemarle Corporation Common Stock
ALDW	# "Alon USA Partners
ALE	# "Allete
ALEX	# "Alexander & Baldwin
ALG	# "Alamo Group
ALJ	# "Alon USA Energy
ALK	# "Alaska Air Group
ALL	# Allstate Corporation (The) Common Stock
ALL$A	# Allstate Corporation (The) Dep Shs Repstg 1/1000th Perp Pfd Ser A
ALL$B	# Allstate Corporation (The) 5.100% Fixed
ALL$C	# Allstate Corporation (The) Dep Shs Repstg 1/1000th Int Shs Pfd Stk Ser C
ALL$D	# The Allstate Corporation Leopards Each Representing A 1/1000th Interest In A Share Of Fixed Rate Noncumulative Perpetual Preferred Stock Series D
ALL$E	# Allstate Corporation Depositary Shares Representing 1/1000th Perpetual Preferred Series E
ALL$F	# Allstate Corporation (The) Leopards Dep Shares Representing 1/1000th Perp Pfd
ALLE	# Allegion plc Ordinary Shares
ALLY	# Ally Financial Inc. Common Stock
ALLY$A	# "GMAC Capital Trust I Fixed Rate Floating Rate Trust Preferred Securities
ALLY$B	# "Ally Financial Inc Fixed Rate Floating Rate Perpetual Preferred Stock
ALP$N	# Alabama Power Company Preferred Stock
ALP$O	# Alabama Power Company Preferred Stock
ALP$P	# Alabama Power Company 5.30% Cl A Pfd Stk
ALR	# Alere Inc. Common Stock
ALR$B	# "Alere Inc. Inverness Medical Innovations
ALSN	# "Allison Transmission Holdings
ALU	# Alcatel
ALV	# "Autoliv
ALX	# "Alexander's
AM	# Antero Midstream Partners LP Common Units representing limited partner interests
AMBR	# "Amber Road
AMC	# "AMC Entertainment Holdings
AME	# "AMETEK
AMFW	# AMEC Foster Wheeler plc American Depositary Shares
AMG	# "Affiliated Managers Group
AMH	# American Homes 4 Rent Common Shares of Beneficial Interest
AMH$A	# American Homes 4 Rent Participating Preferred Shares Series A
AMH$B	# American Homes 4 Rent 5% Series B Participating Preferred Shares of Beneficial Interest
AMH$C	# American Homes 4 Rent Participating Pfd Ser C
AMID	# "American Midstream Partners
AMP	# "Ameriprise Financial
AMRC	# "Ameresco
AMRE	# "AmREIT
AMT	# American Tower Corporation (REIT) Common Stock
AMT$A	# American Tower Corporation (REIT) Pfd Conv Ser A
AMTD	# TD Ameritrade Holding Corporation Common Stock
AMTG	# "Apollo Residential Mortgage
AMTG$A	# "Apollo Residential Mortgage
AMX	# "America Movil
AN	# "AutoNation
ANET	# "Arista Networks
ANF	# Abercrombie & Fitch Company Common Stock
ANFI	# Amira Nature Foods Ltd Ordinary Shares
ANH	# Anworth Mortgage Asset Corporation Common Stock
ANH$A	# Anworth Mortgage Asset Corporation Series A Preferred Stock
ANH$B	# Anworth Mortgage Asset  Corporation Preferred Stock Series B 6.25%
ANN	# ANN INC. Common Stock
ANR	# "Alpha Natural Resources
ANTM	# "Anthem
ANW	# Aegean Marine Petroleum Network Inc. Common Stock
AOD	# Alpine Total Dynamic Dividend Fund Common Stock
AOI	# "Alliance One International
AOL	# AOL Inc. AOL Inc. Common Stock
AON	# Aon plc Class A Ordinary Shares (UK)
AOS	# A.O. Smith Corporation Common Stock
AP	# Ampco
APA	# Apache Corporation Common Stock
APAM	# Artisan Partners Asset Management Inc. Class A Common Stock
APB	# "Asia Pacific Fund
APC	# Anadarko Petroleum Corporation Common Stock
APD	# "Air Products and Chemicals
APF	# Morgan Stanley Asia
APH	# Amphenol Corporation Common Stock
APL	# "Atlas Pipeline Partners
APL$E	# "Atlas Pipeline Partners
APO	# "Apollo Global Management
APU	# "AmeriGas Partners
AR	# Antero Resources Corporation Common Stock
ARC	# "ARC Document Solutions
ARCO	# Arcos Dorados Holdings Inc. Class A Shares
ARCX	# Arc Logistic Partners LP Common Units representing limited partner interest
ARDC	# "Ares Dynamic Credit Allocation Fund
ARE	# "Alexandria Real Estate Equities
ARE$E	# "Alexandria Real Estate Equities
ARES	# Ares Management L.P. Common Units representing Limited Partner Interests
ARG	# "Airgas
ARH$C	# Arch Capital Group Ltd. 6.75% PFD sh S C
ARI	# "Apollo Commercial Real Estate Finance
ARI$A	# Apollo Commercial Real Estate Finance Cumulative Redeemable Perpetual Preferred Stock Series A
ARL	# "American Realty Investors
ARMF	# Ares Multi
ARMK	# Aramark Common Stock
ARN	# Ares Capital Corporation 7.00% Senior Notes due 2022
ARO	# Aeropostale Inc Common Stock
ARP	# "Atlas Resource Partners
ARP$D	# "Atlas Resource Partners
ARPI	# "American Residential Properties
ARR	# "ARMOUR Residential REIT
ARR$A	# Armour Residential REIT INC Preferred Series A
ARR$B	# "ARMOUR Residential REIT
ARU	# Ares Capital Corporation 5.875% Senior Notes due 2022
ARW	# "Arrow Electronics
ARY	# Ares Capital Corporation 7.75% Senior Notes due 2040
ASA	# ASA  Gold and Precious Metals Limited
ASB	# Associated Banc
ASB$B	# Associated Banc
ASC	# Ardmore Shipping Corporation Common Stock
ASG	# Liberty All
ASGN	# "On Assignment
ASH	# Ashland Inc. (NEW) Common Stock
ASPN	# "Aspen Aerogels
ASR	# "Grupo Aeroportuario del Sureste
ASX	# "Advanced Semiconductor Engineering
AT	# Atlantic Power Corporation Ordinary Shares (Canada)
ATE	# Advantest Corporation (Kabushiki Kaisha Advantest) ADS American Depositary Shares
ATEN	# "A10 Networks
ATHM	# "Autohome Inc. American Depositary Shares
ATI	# Allegheny Technologies Incorporated Common Stock
ATK	# Alliant Techsystems Inc. Common Stock
ATLS	# "Atlas Energy
ATO	# Atmos Energy Corporation Common Stock
ATR	# "AptarGroup
ATTO	# Atento S.A. Ordinary Shares
ATU	# Actuant Corporation Common Stock
ATV	# "Acorn International
ATW	# "Atwood Oceanics
AU	# AngloGold Ashanti Limited Common Stock
AUO	# AU Optronics Corp American Depositary Shares
AUQ	# AuRico Gold Inc. Ordinary Shares
AUY	# Yamana Gold Inc. Ordinary Shares (Canada)
AV	# Aviva plc Unsponsored ADR (UK)
AVA	# Avista Corporation Common Stock
AVAL	# Grupo Aval Acciones y Valores S.A. ADR (Each representing 20 preferred shares)
AVB	# "AvalonBay Communities
AVD	# American Vanguard Corporation Common Stock ($0.10 Par Value)
AVG	# AVG Technologies N.V. Ordinary Shares
AVH	# Avianca Holdings S.A. American Depositary Shares (Each representing 8 preferred Shares)
AVIV	# "Aviv REIT
AVK	# Advent Claymore Convertible Securities and Income Fund
AVOL	# Avolon Holdings Limited Common Shares
AVP	# "Avon Products
AVT	# "Avnet
AVV	# Aviva plc Subordinated Capital Securities due 2041
AVX	# AVX Corporation Common Stock
AVY	# Avery Dennison Corporation Common Stock
AWF	# Alliancebernstein Global High Income Fund
AWH	# "Allied World Assurance Company Holdings
AWI	# Armstrong World Industries Inc Common Stock
AWK	# "American Water Works Company
AWP	# Alpine Global Premier Properties Fund Alpine Global Premier Properties Fund Common Shares of Beneficial Interest
AWR	# American States Water Company Common Stock
AXE	# Anixter International Inc. Common Stock
AXL	# "American Axle & Manufacturing Holdings
AXLL	# Axiall Corporation Common Stock
AXP	# American Express Company Common Stock
AXR	# AMREP Corporation Common Stock
AXS	# Axis Capital Holdings Limited Common Stock
AXS$C	# Axis Capital Holdings Limited Preferred Series C (Bermuda)
AXS$D	# Axis Capital Holdings Limited Preferred Series D (Bermuda)
AXTA	# Axalta Coating Systems Ltd. Common Shares
AYI	# Acuity Brands Inc (Holding Company)
AYN	# Alliance New York Municipal Income Fund Inc
AYR	# Aircastle Limited Common Stock
AZN	# Astrazeneca PLC Common Stock
AZO	# "AutoZone
AZZ	# AZZ Incorporated Common Stock
B	# "Barnes Group
BA	# Boeing Company (The) Common Stock
BABA	# Alibaba Group Holding Limited American Depositary Shares each representing one Ordinary share
BAC	# Bank of America Corporation Common Stock
BAC$D	# Bank of America Corporation Depositary Shares Rpstg 1/1000th Interest in Sh of Non Cum Pfd Stk Ser D
BAC$E	# Bank of America Corporation Depositary Sh repstg 1/1000th Perp Pfd Ser E
BAC$I	# Bank Amer Corp Dep Sh Repstg 1/1000th Pfd Ser I
BAC$L	# Bank of America Corporation Non Cumulative Perpetual Conv Pfd Ser L
BAC$W	# Bank of America Corporation Depository Shares Representing 1/1000th Preferred Series W
BAC$Z	# Bank of America Corporation BAC Capital Trust VIII 6% Capital Securities
BAC.A	# "Bank of America Corporation Class A Warrant expiring January 16
BAC.B	# Bank of America Corporation Class B Warrants expiring 10/28/2018
BAF	# BlackRock Municipal Income Investment Quality Trust
BAH	# Booz Allen Hamilton Holding Corporation Common Stock
BAK	# Braskem SA ADR
BALT	# Baltic Trading Limited Common Stock
BAM	# Brookfield Asset Management Inc. Common Stock
BANC	# "Banc of California
BANC$C	# "Banc of California
BAP	# Credicorp Ltd. Common Stock
BAS	# "Basic Energy Services
BAX	# Baxter International Inc. Common Stock
BBD	# Banco Bradesco Sa American Depositary Shares
BBDO	# Banco Bradesco Sa American Depositary Shares (each representing one Common Share)
BBF	# BlackRock Municipal Income Investment Trust
BBG	# Bill Barrett Corporation Common Stock
BBK	# Blackrock Municipal Bond Trust
BBL	# BHP Billiton plc Sponsored ADR
BBN	# BlackRock Build America Bond Trust Common Shares of Beneficial Interest
BBT	# BB&T Corporation Common Stock
BBT$D	# BB&T Corporation Depositary Shares Representing 1/1000th Perpetual Preferred Series D
BBT$E	# BB&T Corporation Depositary Shares Representing 1/1000th Perpetual Preferred Series E
BBT$F	# BB&T Corporation Depositary Shares Representing 1/1000th Interest Series F Perpetual Preferred
BBT$G	# BB&T Corporation Depositary Shares Representing 1/1000th Perpetual Preferred Series G
BBVA	# Banco Bilbao Vizcaya Argentaria S.A. Common Stock
BBW	# Build
BBX	# BBX Capital Corporation Common Stock
BBY	# "Best Buy Co.
BC	# Brunswick Corporation Common Stock
BCA	# Corpbanca Sponsored Reg S GDR representing Common (Chile)
BCC	# "Boise Cascade
BCE	# "BCE
BCEI	# "Bonanza Creek Energy
BCH	# Banco De Chile Banco De Chile ADS
BCO	# Brinks Company (The) Common Stock
BCR	# "C.R. Bard
BCRH	# Blue Capital Reinsurance Holdings Ltd. Common Shares
BCS	# Barclays PLC Common Stock
BCS$	# Barclays Bank PLC ADR Ser 2 repstg Pref Shs Ser 2 (United Kingdom)
BCS$A	# Barclays PLC ADS
BCS$C	# Barclays PLC American Depositary Shares Series 4
BCS$D	# Barclays PLC American Depositary Shares (Each representing Non
BCX	# BlackRock Resources Common Shares of Beneficial Interest
BDC	# Belden Inc Common Stock
BDJ	# Blackrock Enhanced Equity Dividend Trust
BDN	# Brandywine Realty Trust Common Stock
BDN$E	# Brandywine Realty Tr Pfd Shs Ben Int Ser E
BDX	# "Becton
BEE	# Strategic Hotels & Resorts  Inc Common Stock
BEL	# Belmond Ltd. Class A Common Stock
BEN	# "Franklin Resources
BEP	# Brookfield Renewable Energy Partners LP Partnership Units (Bermuda)
BERY	# "Berry Plastics Group
BF.A	# Brown Forman Inc Class A Common Stock
BF.B	# Brown Forman Inc Class B Common Stock
BFAM	# Bright Horizons Family Solutions Inc. Common Stock
BFK	# BlackRock Municipal Income Trust
BFO	# Blackrock Florida Municipal 2020 Term Trust
BFR	# BBVA Banco Frances S.A. Common Stock
BFS	# "Saul Centers
BFS$C	# "Saul Centers
BFZ	# BlackRock California Municipal Income Trust
BG	# Bunge Limited Bunge Limited
BGB	# Blackstone / GSO Strategic Credit Fund Common Shares
BGC	# General Cable Corporation Common Stock
BGCA	# "BGC Partners
BGE$B	# Bge Cap Trust II 6.20% Trust Preferred Securities
BGG	# Briggs & Stratton Corporation Common Stock
BGH	# Babson Capital Global Short Duration High Yield Fund Common Shares of Beneficial Interests
BGR	# BlackRock Energy and Resources Trust
BGS	# "B&G Foods
BGT	# BlackRock Floating Rate Income Trust
BGX	# Blackstone GSO Long Short Credit Income Fund Common Shares
BGY	# "BLACKROCK INTERNATIONAL
BH	# Biglari Holdings Inc.
BHE	# "Benchmark Electronics
BHI	# Baker Hughes Incorporated Common Stock
BHK	# Blackrock Core Bond Trust Blackrock Core Bond Trust
BHL	# Blackrock Defined Opportunity Credit Trust Blackrock Defined Opportunity Credit Trust
BHLB	# "Berkshire Hills Bancorp
BHP	# BHP Billiton Limited Common Stock
BID	# Sotheby's Common Stock
BIE	# BlackRock Municipal Bond Investment Trust
BIF	# "Boulder Growth & Income Fund
BIG	# "Big Lots
BIN	# Progressive Waste Solutions Ltd. Common Shares
BIO	# Bio
BIO.B	# Bio
BIOA	# BioAmber Inc. Common Stock
BIOA.W	# "BioAmber Inc. Warrant
BIP	# Brookfield Infrastructure Partners LP Limited Partnership Units
BIT	# BlackRock Multi
BITA	# Bitauto Holdings Limited American Depositary Shares (each representing one ordinary share)
BJZ	# Blackrock California Municipal 2018 Term Trust Blackrock California Municipal 2018 Term Trust
BK	# Bank of New York Mellon Corporation (The) Common Stock
BK$C	# Bank Of New York Mellon Corporation (The) Dep Shs Repstg 1/4000th Perp Pfd Ser C
BKD	# Brookdale Senior Living Inc. Common Stock
BKE	# "Buckle
BKH	# Black Hills Corporation Common Stock
BKK	# Blackrock Municipal 2020 Term Trust
BKN	# BlackRock Investment Quality Municipal Trust Inc. (The)
BKS	# "Barnes & Noble
BKT	# BlackRock Income Trust Inc. (The)
BKU	# "BankUnited
BLH	# Blackrock New York Municipal 2018 Term Trust
BLK	# "BlackRock
BLL	# Ball Corporation Common Stock
BLOX	# Infoblox Inc. Common Stock
BLT	# "Blount International
BLW	# Blackrock Limited Duration Income Trust
BLX	# "Banco Latinoamericano de Comercio Exterior
BMA	# Banco Macro S.A.  ADR (representing Ten Class B Common Shares)
BME	# Blackrock Health Sciences Trust
BMI	# "Badger Meter
BML$G	# Bank of America Corporation Bank of America Corporation Depositary Shares (Each representing a 1/1200th interest in a share of Floating Rate Non
BML$H	# Bank of America Corporation Bank of America Corporation Depositary Shares (Each representing a 1/1200th interest in a Share of Floating Rate Non
BML$I	# Bank of America Corporation Bank of America Corporation Depositary Shares (Each representing a 1/1200th interest in a Share of 6.375% Non
BML$J	# Bank of America Corporation Bank of America Corporation Depositary Shares (Each representing a 1/1200th interest in a Share of Floating Rate Non
BML$L	# Bank of America Corporation Bank of America Corporation Depositary Shares (Each representing a 1/1200th Interest in a Share of Floating Rate Non
BMO	# Bank Of Montreal Common Stock
BMR	# Biomed Realty Trust Common Stock
BMS	# "Bemis Company
BMY	# Bristol
BNJ	# BlackRock New Jersey Municipal Income Trust
BNK	# "C1 Financial
BNS	# Bank Nova Scotia Halifax Pfd 3 Ordinary Shares
BNY	# BlackRock New York Municipal Income Trust
BOCA	# "Banc of California
BOE	# Blackrock Global Blackrock Global Opportunities Equity Trust Common Shares of Beneficial Interest
BOH	# Bank of Hawaii Corporation Common Stock
BOI	# Brookfield Mortgage Opportunity Income Fund Inc. Common Stock
BOOT	# "Boot Barn Holdings
BORN	# China New Borun Corporation American Depositary Shares
BOXC	# Brookfield Canada Office Properties
BP	# BP p.l.c. Common Stock
BPI	# "Bridgepoint Education
BPK	# Blackrock Municipal 2018 Term Trust Blackrock Municipal 2018 Term Trust
BPL	# Buckeye Partners L.P. Common Stock
BPT	# BP Prudhoe Bay Royalty Trust Common Stock
BPY	# Brookfield Property Partners L.P. Limited Partnership Units
BPZ	# "BPZ Resources
BQH	# Blackrock New York Municipal Bond Trust Common Shares of Beneficial Interest
BR	# "Broadridge Financial Solutions
BRC	# Brady Corporation Common Stock
BRFS	# BRF S.A.
BRK.A	# Berkshire Hathaway Inc. Common Stock
BRK.B	# Berkshire Hathaway Inc. New Common Stock
BRO	# "Brown & Brown
BRP	# Brookfield Residential Properties Inc. Common Stock
BRS	# Bristow Group Inc. Common Stock
BRSS	# "Global Brass and Copper Holdings
BRT	# BRT Realty Trust Common Stock
BRX	# Brixmor Property Group Inc. Common Stock
BSAC	# Banco Santander
BSBR	# "Banco Santander Brasil SA American Depositary Shares
BSD	# BlackRock Strategic Municipal Trust Inc. (The) Common Stock
BSE	# Blackrock New York Municipal Income Quality Trust Common Shares of Beneficial Interest
BSI	# Alon Blue Square Israel Ltd.
BSL	# Blackstone GSO Senior Floating Rate Term Fund Common Shares of Beneficial Interest
BSMX	# "Grupo Financiero Santander Mexico S.A. B. de C.V. American Depositary Shares
BST	# BlackRock Science and Technology Trust Common Shares of Beneficial Interest
BSX	# Boston Scientific Corporation Common Stock
BT	# BT Group plc Common Stock
BTA	# BlackRock Long
BTE	# Baytex Energy Corp
BTF	# "Boulder Total Return Fund
BTH	# "Blyth
BTO	# John Hancock Financial Opportunities Fund Common Stock
BTT	# BlackRock Municipal Target Term Trust Inc. (The) Common Shares of Beneficial Interest
BTU	# Peabody Energy Corporation Common Stock
BTZ	# BlackRock Credit Allocation Income Trust
BUD	# Anheuser
BUI	# BlackRock Utility and Infrastructure Trust Common Shares of Beneficial Interest
BURL	# "Burlington Stores
BVN	# Buenaventura Mining Company Inc.
BWA	# BorgWarner Inc. Common Stock
BWC	# Babcock Common Stock
BWG	# Legg Mason BW Global Income Opportunities Fund Inc. Common Stock
BWP	# Boardwalk Pipeline Partners LP Common Units
BWS	# "Brown Shoe Company
BX	# The Blackstone Group L.P. Common Units Representing Limited Partnership Interests
BXC	# Bluelinx Holdings Inc. Common Stock
BXE	# Bellatrix Exploration Ltd Ordinary Shares (Canada)
BXMT	# "Blackstone Mortgage Trust
BXMX	# Nuveen S&P 500 Buy
BXP	# "Boston Properties
BXP$B	# "Boston Properties
BXS	# "BancorpSouth
BYD	# Boyd Gaming Corporation Common Stock
BYM	# Blackrock Municipal Income Quality Trust Common Shares of Beneficial Interest
BZH	# "Beazer Homes USA
BZT	# "Beazer Homes USA
C	# "Citigroup
C$C	# Citigroup Inc. Depositary Shares representing 1/1000 Series C Noncumulative Preferred Stock (United States)
C$J	# Citigroup Inc. Dep Shs Repstg 1/1000 Pfd Ser J Fixed/Fltg
C$K	# Citigroup Inc. Dep Shs Repstg 1/1000th Pfd Ser K
C$L	# Citigroup Inc. Depositary Share representing 1/1000 interest in a share of noncumulative series L
C$N	# Citigroup Capital VIII 7.875% Fixed rate Floating Rate trust Preferred Securities (TruPS)
C$P	# Citigroup Inc. Dep Shs Repstg 1/1000th Pfd Ser AA
C.A	# "Citigroup Inc. Warrants Class A expiring January 4
C.B	# "Citigroup Inc. Class B Warant expiring October 28
CAB	# Cabela's Inc Class A Common Stock
CACI	# "CACI International
CAE	# CAE Inc. Ordinary Shares
CAF	# Morgan Stanley China A Share Fund Inc. Common Stock
CAG	# "ConAgra Foods
CAH	# "Cardinal Health
CAJ	# "Canon
CALX	# "Calix
CAM	# Cameron International Corporation Common Stock
CAP	# "Cai International
CAPL	# CrossAmerica Partners LP Common Units representing limited partner interests
CAS	# Castle (A.M.) & Co. Common Stock
CAT	# "Caterpillar
CATO	# Cato Corporation (The) Class A Common Stock
CB	# Chubb Corporation (The) Common Stock
CBA	# ClearBridge American Energy MLP Fund Inc. Common Stock
CBB	# Cincinnati Bell Inc. Common Stock
CBB$B	# Cincinnati Bell Inc. Preferred Stock
CBD	# Companhia Brasileira de Distribuicao ADS
CBG	# CBRE Group Inc Common Stock Class A
CBI	# Chicago Bridge & Iron Company N.V. Common Stock
CBK	# Christopher & Banks Corporation Common Stock
CBL	# "CBL & Associates Properties
CBL$D	# "CBL & Associates Properties
CBL$E	# "CBL & Associates Properties
CBM	# Cambrex Corporation Common Stock
CBPX	# "Continental Building Products
CBR	# "Ciber
CBS	# CBS Corporation Class B Common Stock
CBS.A	# CBS Corporation CBS Corporation Class A Common Stock
CBT	# Cabot Corporation Common Stock
CBU	# "Community Bank System
CBZ	# "CBIZ
CCC	# Calgon Carbon Corporation Common Stock
CCE	# Coca
CCG	# "Campus Crest Communities
CCG$A	# "Campus Crest Communities
CCI	# Crown Castle International Corp. (REIT) Common Stock
CCI$A	# Crown Castle International Corp. (REIT) Mandatory Conv Pfd Stk Series A
CCJ	# Cameco Corporation Common Stock
CCK	# "Crown Holdings
CCL	# Carnival Corporation Common Stock
CCM	# Concord Medical Services Holdings Limited ADS (Each represents three ordinary shares)
CCO	# "Clear Channel Outdoor Holdings
CCS	# "Century Communities
CCSC	# "Country Style Cooking Restaurant Chain Co.
CCU	# "Compania Cervecerias Unidas
CCV	# Comcast Corporation 5.00% Notes due 2061
CCZ	# Comcast Holdings ZONES
CDE	# "Coeur Mining
CDE.W	# "Coeur Mining
CDI	# CDI Corporation Common Stock
CDR	# "Cedar Realty Trust
CDR$B	# "Cedar Realty Trust
CE	# Celanese Corporation Celanese Corporation Series A Common Stock
CEA	# China Eastern Airlines Corporation Ltd. Common Stock
CEB	# Corporate Executive Board Company (The) Common Stock
CEE	# "Central Europe
CEL	# "Cellcom Israel
CELP	# "Cypress Energy Partners
CEM	# ClearBridge Energy MLP Fund Inc. Common Stock
CEN	# Center Coast MLP & Infrastructure Fund Common Shares of Beneficial Interest
CEO	# CNOOC Limited Common Stock
CEQP	# Crestwood Equity Partners LP
CF	# "CF Industries Holdings
CFC$A	# Countrywide Capital IV (New) 6.75% Trust Pfd Securities
CFC$B	# Countrywide Capital V (New) 7.00% Capital Securities
CFG	# "Citizens Financial Group
CFI	# "Culp
CFN	# CareFusion Corporation Common Stock
CFR	# "Cullen/Frost Bankers
CFR$A	# "Cullen/Frost Bankers
CFX	# Colfax Corporation Common Stock
CGA	# "China Green Agriculture
CGG	# CGG
CGI	# "Celadon Group
CHA	# China Telecom Corp Ltd ADS
CHD	# "Church & Dwight Company
CHE	# Chemed Corp
CHGG	# "Chegg
CHH	# "Choice Hotels International
CHK	# Chesapeake Energy Corporation Common Stock
CHK$D	# Chesapeake Energy Corporation Convertible Preferred
CHKR	# Chesapeake Granite Wash Trust Common Units representing beneficial interests in the Trust
CHL	# China Mobile Limited Common Stock
CHMI	# Cherry Hill Mortgage Investment Corporation Common Stock
CHMT	# Chemtura Corp. Common Stock
CHN	# "China Fund
CHS	# "Chico's FAS
CHSP	# Chesapeake Lodging Trust Common Shares of Beneficial Interest
CHSP$A	# Chesapeake Lodging Trust 7.75% Series A Cumulative Redeemable Preferred Shares
CHT	# "Chunghwa Telecom Co.
CHU	# China Unicom (Hong Kong) Ltd Common Stock
CI	# Cigna Corporation Common Stock
CIA	# "Citizens
CIB	# BanColombia S.A. Common Stock
CIE	# "Cobalt International Energy
CIEN	# Ciena Corporation Common Stock
CIF	# MFS Intermediate High Income Fund Common Stock
CIG	# Comp En De Mn Cemig ADS American Depositary Shares
CIG.C	# Comp En De Mn Cemig ADS American Depositary Receipts
CII	# "Blackrock Capital and Income Fund
CIM	# Chimera Investment Corporation Common Stock
CIO	# "City Office REIT
CIR	# "CIRCOR International
CIT	# CIT Group Inc (DEL) Common Stock
CIVI	# "Civitas Solutions
CJES	# "C&J Energy Services
CKH	# SEACOR Holdings Inc. Common Stock
CKP	# "Checkpoint Systms
CL	# Colgate
CLA	# Capitala Finance Corp. 7.125% Notes due 2021
CLB	# Core Laboratories N.V. Common Stock
CLC	# CLARCOR Inc. Common Stock
CLD	# Cloud Peak Energy Inc Common Stock
CLDT	# Chatham Lodging Trust (REIT) Common Shares of Beneficial Interest
CLF	# Cliffs Natural Resources Inc Common Stock
CLGX	# "CoreLogic
CLH	# "Clean Harbors
CLI	# Mack
CLNY	# "Colony Financial
CLNY$A	# Colony Finl Inc Cum Red Perp Pfd Ser A %
CLNY$B	# "Colony Financial
CLR	# "Continental Resources
CLS	# "Celestica
CLV	# Cliffs Natural Resources Inc. Depositary Shares Representing 1/40th Preferred Convertible Series A
CLW	# Clearwater Paper Corporation Common Stock
CLX	# Clorox Company (The) Common Stock
CM	# Canadian Imperial Bank of Commerce Common Stock
CMA	# Comerica Incorporated Common Stock
CMA.W	# "Comerica Incorporated Warrant expiring November 14
CMC	# Commercial Metals Company Common Stock
CMCM	# "Cheetah Mobile Inc. American Depositary Shares
CMG	# "Chipotle Mexican Grill
CMI	# Cummins Inc. Common Stock
CMK	# MFS Intermarket Income Trust I Common Stock
CMLP	# Crestwood Midstream Partners LP
CMN	# Cantel Medical Corp. Common Stock
CMO	# Capstead Mortgage Corporation Common Stock
CMO$E	# Capstead Mortgage Corporation Pfd Ser E
CMP	# Compass Minerals Intl Inc Common Stock
CMRE	# Costamare Inc. Common Stock $0.0001 par value
CMRE$B	# Costamare Inc. Perpetual Preferred Stock Series B (Marshall Islands)
CMRE$C	# Costamare Inc. Perpetual Preferred Series C (Marshall Islands)
CMS	# CMS Energy Corporation Common Stock
CMS$B	# CMS Energy Corporation Preferred Stock
CMU	# MFS Municipal Income Trust Common Stock
CNA	# CNA Financial Corporation Common Stock
CNC	# Centene Corporation Common Stock
CNCO	# Cencosud S.A. American Depositary Shares (Each representing three Common Shares)
CNHI	# CNH Industrial N.V. Common Shares
CNI	# Canadian National Railway Company Common Stock
CNK	# "Cinemark Holdings Inc Cinemark Holdings
CNL	# Cleco Corporation Common Stock
CNNX	# Cone Midstream Partners LP Common Units representing limited partner interests
CNO	# "CNO Financial Group
CNP	# "CenterPoint Energy
CNQ	# Canadian Natural Resources Limited Common Stock
CNS	# Cohn & Steers Inc Common Stock
CNW	# Con
CNX	# CONSOL Energy Inc. Common Stock
CO	# China Cord Blood Corporation Common Stock
CODE	# Spansion Inc Common Stock Class A New
CODI	# Compass Diversified Holdings Shares of Beneficial Interest
COF	# Capital One Financial Corporation Common Stock
COF$C	# Capital One Financial Corp Depository Shares Representing 1/40th Int Perp Pfd Ser C%
COF$D	# Capital One Financial Corp Depository Shares Representing 1/40th Interest Perpetual Preferred Series D
COF$P	# Capital One Financial Corp Pfd Ser B
COF.W	# "Capital One Financial Corporation Warrants expiring November 14
COG	# Cabot Oil & Gas Corporation Common Stock
COH	# "Coach
COL	# "Rockwell Collins
COO	# "Cooper Companies
COP	# ConocoPhillips Common Stock
COR	# CoreSite Realty Corporation Common Stock
COR$A	# CoreSite Realty Corporation Pfd Ser A
CORR	# "CorEnergy Infrastructure Trust
COT	# Cott Corporation Common Stock
COTY	# Coty Inc. Class A Common Stock
COUP	# Coupons.com Incorporated Common Stock
COV	# Covidien plc. Ordinary Shares (Ireland)
CP	# Canadian Pacific Railway Limited Common Stock
CPA	# "Copa Holdings
CPAC	# "Cementos Pacasmayo S.A.A. American Depositary Shares
CPB	# Campbell Soup Company Common Stock
CPE	# Callon Petroleum Company Common Stock
CPE$A	# Callon Petroleum Company Preferred Shares Series A 10%
CPF	# Central Pacific Financial Corp New
CPG	# Crescent Point Energy Corporation Ordinary Shares (Canada)
CPK	# Chesapeake Utilities Corporation Common Stock
CPL	# CPFL Energia S.A. CPFL Energia S.A. American Depositary Shares
CPN	# Calpine Corporation Common Stock
CPS	# Cooper
CPT	# Camden Property Trust Common Stock
CR	# Crane Company Common Stock
CRC	# California Resources Corporation Common Stock
CRCM	# "Care.com
CRD.A	# Crawford & Company Common Stock
CRD.B	# Crawford & Company Common Stock
CRH	# CRH PLC American Depositary Shares
CRI	# "Carter's
CRK	# "Comstock Resources
CRL	# "Charles River Laboratories International
CRM	# Salesforce.com Inc Common Stock
CRR	# "Carbo Ceramics
CRS	# Carpenter Technology Corporation Common Stock
CRT	# Cross Timbers Royalty Trust Common Stock
CRY	# "CryoLife
CS	# Credit Suisse Group American Depositary Shares
CSC	# Computer Sciences Corporation Common Stock
CSG	# Chambers Street Properties Common Shares of Beneficial Interest
CSH	# "Cash America International
CSI	# Cutwater Select Income Fund
CSL	# Carlisle Companies Incorporated Common Stock
CSLT	# "Castlight Health
CSS	# "CSS Industries
CST	# "CST Brands
CSTM	# Constellium N.V. Ordinary Shares
CSU	# Capital Senior Living Corporation Common Stock
CSV	# "Carriage Services
CSX	# CSX Corporation Common Stock
CTB	# Cooper Tire & Rubber Company Common Stock
CTL	# "CenturyLink
CTLT	# "Catalent
CTQ	# Qwest Corporation 7.375% Notes due 2051
CTR	# ClearBridge Energy MLP Total Return Fund Inc. Common Stock
CTS	# CTS Corporation Common Stock
CTT	# "CatchMark Timber Trust
CTU	# Qwest Corporation 7.00% Notes due 2025
CTV	# Qwest Corporation 6.875% Notes due 2054
CTW	# Qwest Corporation 7.50% Notes due 2051
CTX	# Qwest Corporation 7.00% Notes due 2052
CTY	# Qwest Corporation 6.125% Notes due 2053
CUB	# Cubic Corporation Common Stock
CUBE	# CubeSmart Common Shares
CUBE$A	# CubeSmart 7.75% Series A Cumulative Redeemable Preferred Shares of Beneficial Interest
CUBI	# "Customers Bancorp
CUBS	# "Customers Bancorp
CUDA	# "Barracuda Networks
CUK	# Carnival Plc ADS ADS
CUZ	# Cousins Properties Incorporated Common Stock
CVA	# Covanta Holding Corporation Common Stock
CVB	# "Lehman ABS Corporation 7.75% Corp Backed Tr Ctfs
CVC	# Cablevision Systems Corporation Class A Common Stock
CVD	# Covance Inc. Common Stock
CVE	# Cenovus Energy Inc Common Stock
CVEO	# Civeo Corporation Common Stock
CVG	# Convergys Corporation Common Stock
CVI	# CVR Energy Inc. Common Stock
CVO	# Cenveo Inc
CVRR	# "CVR Refining
CVS	# CVS Health Corporation Common Stock
CVT	# "CVENT
CVX	# Chevron Corporation Common Stock
CW	# Curtiss
CWEI	# "Clayton Williams Energy
CWT	# California Water Service Group Common Stock
CX	# "Cemex
CXE	# MFS High Income Municipal Trust Common Stock
CXH	# MFS Investment Grade Municipal Trust Common Stock
CXO	# Concho Resources Inc. Common Stock
CXP	# "Columbia Property Trust
CXW	# Corrections Corporation of America Common Stock
CYD	# China Yuchai International Limited Common Stock
CYH	# "Community Health Systems
CYN	# City National Corporation Common Stock
CYN$C	# City National Corporation Depositary Shares Representing 1/40th Perpetual Preferred Series Series C
CYN$D	# City National Corporation Depositary Shares Representing 1/40th Preferred Series D Fixed/Floating
CYNI	# "Cyan
CYS	# "CYS Investments
CYS$A	# CYS Investments Inc Cumulative Redeemable Preferred Series A
CYS$B	# "CYS Investments
CYT	# Cytec Industries Inc. Common Stock
CZZ	# Cosan Limited Class A Common Stock
D	# "Dominion Resources
DAC	# Danaos Corporation Common Stock
DAL	# "Delta Air Lines
DAN	# Dana Holding Corporation Common Stock When
DANG	# E
DAR	# Darling Ingredients Inc. Common Stock
DATA	# "Tableau Software
DB	# Deutsche Bank AG Common Stock
DBD	# "Diebold
DBL	# DoubleLine Opportunistic Credit Fund Common Shares of Beneficial Interest
DCA	# Virtus Total Return Fund
DCI	# "Donaldson Company
DCM	# "NTT DOCOMO
DCO	# Ducommun Incorporated Common Stock
DCT	# DCT Industrial Trust Inc Common Stock
DCUA	# "Dominion Resources
DCUB	# "Dominion Resources
DCUC	# "Dominion Resources
DD	# E.I. du Pont de Nemours and Company Common Stock
DD$A	# E.I. du Pont de Nemours and Company Preferred Stock
DD$B	# E.I. du Pont de Nemours and Company Preferred Stock
DDC	# Dominion Diamond Corporation Common Stock
DDD	# 3D Systems Corporation Common Stock
DDE	# Dover Downs Gaming & Entertainment Inc Common Stock
DDF	# "Delaware Investments Dividend & Income Fund
DDR	# DDR Corp. Common Stock
DDR$J	# DDR Corporation Dep Shs Repstg 1/20th Pfd Cl J
DDR$K	# DDR Corp. DEPOSITARY SH REPSTG 1/20TH PDF CL K % (United States)
DDS	# "Dillard's
DDT	# Dillard's Capital Trust I
DE	# Deere & Company Common Stock
DECK	# Deckers Outdoor Corporation Common Stock
DEG	# "Etablissements Delhaize Freres et Cie ""Le Lion"" S.A. Common Stock"
DEI	# "Douglas Emmett
DEL	# Deltic Timber Corporation Common Stock
DEO	# Diageo plc Common Stock
DEX	# Delaware Enhanced Global Dividend Common Shares of Beneficial Interest
DF	# Dean Foods Company Common Stock
DFP	# Flaherty & Crumrine Dynamic Preferred and Income Fund Inc. Common Stock
DFS	# Discover Financial Services Common Stock
DFS$B	# Discover Financial Services Dep Shs
DFT	# "Dupont Fabros Technology
DFT$A	# DuPont Fabros Technology Inc CUMULATIVE RED PERP PFD SER A
DFT$B	# "Dupont Fabros Technology
DG	# Dollar General Corporation Common Stock
DGI	# "DigitalGlobe
DGX	# Quest Diagnostics Incorporated Common Stock
DHF	# Dreyfus High Yield Strategies Fund Common Stock
DHG	# "Deutsche High Income Opportunities Fund
DHI	# "D.R. Horton
DHR	# Danaher Corporation Common Stock
DHT	# "DHT Holdings
DHX	# "Dice Holdings
DIAX	# Nuveen Dow 30SM Dynamic Overwrite Fund Common Shares of Beneficial Interest
DIN	# "DineEquity
DIS	# Walt Disney Company (The) Common Stock
DK	# "Delek US Holdings
DKL	# "Delek Logistics Partners
DKS	# Dick's Sporting Goods Inc Common Stock
DKT	# Deutsch Bk Contingent Cap Tr V Tr Pfd Secs
DL	# China Distance Education Holdings Limited American Depositary Shares
DLB	# Dolby Laboratories Common Stock
DLNG	# Dynagas LNG Partners LP Common Units
DLPH	# Delphi Automotive plc Ordinary Shares
DLR	# "Digital Realty Trust
DLR$E	# "Digital Realty Trust
DLR$F	# "Digital Realty Trust
DLR$G	# "Digital Realty Trust
DLR$H	# "Digital Realty Trust
DLX	# Deluxe Corporation Common Stock
DM	# "Dominion Midstream Partners
DMB	# "Dreyfus Municipal Bond Infrastructure Fund
DMD	# Demand Media Inc. Common Stock
DMO	# Western Asset Mortgage Defined Opportunity Fund Inc Common Stock
DNB	# Dun & Bradstreet Corporation (The) Common Stock
DNI	# Dividend and Income Fund Common Stock
DNOW	# NOW Inc. Common Stock
DNP	# "DNP Select Income Fund
DNR	# Denbury Resources Inc. Common Stock
DNY	# The Denali Fund Inc
DO	# "Diamond Offshore Drilling
DOC	# Physicians Realty Trust Common Shares of Beneficial Interest
DOM	# Dominion Resources Black Warrior Trust Common Stock
DOOR	# Masonite International Corporation Ordinary Shares (Canada)
DOV	# Dover Corporation Common Stock
DOW	# Dow Chemical Company (The) Common Stock
DPG	# Duff & Phelps Global Utility Income Fund Inc. Common Stock
DPLO	# "Diplomat Pharmacy
DPM	# "DCP Midstream Partners
DPS	# "Dr Pepper Snapple Group
DPZ	# Domino's Pizza Inc Common Stock
DQ	# "DAQO New Energy Corp. American Depositary Shares
DRA	# Diversified Real Asset Income Fund Common Shares of Beneficial Interest
DRC	# Dresser
DRD	# DRDGOLD Limited American Depositary Shares
DRE	# Duke Realty Corporation Common Stock
DRH	# Diamondrock Hospitality Company Common Stock
DRI	# "Darden Restaurants
DRII	# "Diamond Resorts International
DRL	# Doral Financial Corporation NEW Common Stock
DRQ	# Dril
DSE	# Duff & Phelps Select Energy MLP Fund Inc. Common Stock
DSL	# DoubleLine Income Solutions Fund Common Shares of Beneficial Interests
DSM	# "Dreyfus Strategic Municipal Bond Fund
DST	# "DST Systems
DSU	# "Blackrock Debt Strategies Fund
DSW	# DSW Inc. Common Stock
DSX	# Diana Shipping inc. common stock
DSX$B	# Diana Shipping Inc. Perpetual Preferred Shares Series B (Marshall Islands)
DTE	# DTE Energy Company Common Stock
DTF	# DTF Tax
DTK	# Deutsche Bk Contingent Cap Tr III Tr Pfd Secs
DTLA$	# Brookfield DTLA Inc. 7.625% Series A Cumulative Redeemable Preferred Stock
DTQ	# "DTE Energy Company 2012 Series C 5.25% Junior Subordinate Debentures due December 1
DTT	# Deutsche Bank Cap Fdg Tr IX Guaranteed Trust Preferred Securities
DTZ	# DTE Energy Company 2011 Series I 6.50% Junior Subordinate Debentures due 2061
DUA	# Deutsche Bank Cap Fdg Tr VIII 6.375% Tr Pfd Secs
DUC	# "Duff & Phelps Utility & Corporate Bond Trust
DUK	# Duke Energy Corporation (Holding Company) Common Stock
DUKH	# Duke Energy Corporation 5.125% Junior Subordinated Debentures due 2073
DV	# DeVry Education Group Inc. Common Stock
DVA	# DaVita HealthCare Partners Inc. Common Stock
DVD	# "Dover Motorsports
DVN	# Devon Energy Corporation Common Stock
DW	# Drew Industries Incorporated Common Stock ($0.01 Par Value)
DWRE	# "DEMANDWARE
DX	# "Dynex Capital
DX$A	# "Dynex Capital
DX$B	# "Dynex Capital
DXB	# Deutsche Bk Contingent Cap TR II Tr Pfd Sec
DY	# "Dycom Industries
DYN	# Dynegy Inc. Common Stock
DYN$A	# Dynegy Inc. Mandatory Preferred Convertible Series A%
DYN.W	# "Dynegy Inc. Warrant expiring October 2
E	# ENI S.p.A. Common Stock
EAA	# "Entergy Arkansas
EAB	# "Entergy Arkansas
EAE	# "Entergy Arkansas
EARN	# Ellington Residential Mortgage REIT Common Shares of Beneficial Interest
EAT	# "Brinker International
EBF	# "Ennis
EBR	# Centrais Elc Braz Pfb B Elbras American Depositary Shares
EBR.B	# Centrais Elc Braz Pfb B Elbras American Depositary Shares
EBS	# "Emergent Biosolutions
EC	# Ecopetrol S.A. American Depositary Shares
ECA	# Encana Corporation
ECC	# Eagle Point Credit Company Inc. Common Stock
ECL	# Ecolab Inc. Common Stock
ECOM	# ChannelAdvisor Corporation Common Stock
ECR	# Eclipse Resources Corporation Common Stock
ECT	# ECA Marcellus Trust I Common Units of Beneficial Interest
ED	# "Consolidated Edison
EDD	# "Morgan Stanley Emerging Markets Domestic Debt Fund
EDE	# Empire District Electric Company (The) Common Stock
EDF	# Stone Harbor Emerging Markets Income Fund Common Shares of Beneficial Interest
EDI	# Stone Harbor Emerging Markets Total Income Fund Common Shares of Beneficial Interests
EDN	# Empresa Distribuidora Y Comercializadora Norte S.A. (Edenor) Empresa Distribuidora Y Comercializadora Norte S.A. (Edenor) American Depositary Shares
EDR	# "Education Realty Trust
EDU	# "New Oriental Education & Technology Group
EE	# El Paso Electric Company Common Stock
EEA	# "The European Equity Fund
EEP	# "Enbridge Energy
EEQ	# Enbridge Energy Management LLC Shares repstg limited liability company interests
EFC	# "Ellington Financial LLC Common Shares representing Limitied Liability Company Interests
EFF	# Eaton vance Floating
EFM	# "Entergy Mississippi
EFR	# Eaton Vance Senior Floating
EFT	# Eaton Vance Floating Rate Income Trust Common Shares of Beneficial Interest
EFX	# "Equifax
EGF	# "Blackrock Enhanced Government Fund
EGL	# "Engility Holdings
EGN	# Energen Corporation Common Stock
EGO	# Eldorado Gold Corporation Ordinary Shares
EGP	# "EastGroup Properties
EGY	# Vaalco Energy Inc Common Stock
EHI	# Western Asset Global High Income Fund Inc Common Stock
EHIC	# eHi Car Services Limited American Depositary Shares
EIG	# Employers Holdings Inc Common Stock
EIX	# Edison International Common Stock
EJ	# E
EL	# "Estee Lauder Companies
ELA	# "Entergy Louisiana
ELB	# "Entergy Louisiana
ELJ	# "Entergy Louisiana
ELLI	# "Ellie Mae
ELP	# Companhia Paranaense de Energia (COPEL) Common Stock
ELS	# "Equity Lifestyle Properties
ELS$C	# "Equity Lifestyle Properties
ELU	# "Entergy Louisiana
ELX	# Emulex Corporation Common Stock
ELY	# Callaway Golf Company Common Stock
EMC	# EMC Corporation Common Stock
EMD	# "Western Asset Emerging Markets Income Fund
EME	# "EMCOR Group
EMES	# Emerge Energy Services LP Common Units representing Limited Partner Interests
EMF	# Templeton Emerging Markets Fund Common Stock
EMN	# Eastman Chemical Company Common Stock
EMO	# ClearBridge Energy MLP Opportunity Fund Inc. Common Stock
EMQ	# "Entergy Mississippi
EMR	# Emerson Electric Company Common Stock
EMZ	# "Entergy Mississippi
ENB	# Enbridge Inc Common Stock
ENBL	# "Enable Midstream Partners
ENH	# Endurance Specialty Holdings Ltd Common Stock
ENH$A	# Endurance Specialty Holdings Ltd Preferred Series A
ENH$B	# Endurance Specialty Holdings Ltd PFD SER B (Bermuda)
ENI	# Enersis S A Common Stock
ENJ	# "Entergy New Orleans
ENL	# Reed Elsevier NV American Depositary Shares
ENLC	# "EnLink Midstream
ENLK	# "EnLink Midstream Partners
ENR	# "Energizer Holdings
ENS	# Enersys Common Stock
ENV	# "Envestnet
ENVA	# "Enova International
ENZ	# "Enzo Biochem
EOC	# Empresa Nacional de Electricidad S.A. Common Stock
EOD	# Wells Fargo Advantage Global Dividend Opportunity Fund
EOG	# "EOG Resources
EOI	# Eaton Vance Enhance Equity Income Fund Eaton Vance Enhanced Equity Income Fund Shares of Beneficial Interest
EOS	# Eaton Vance Enhance Equity Income Fund II Common Stock
EOT	# Eaton Vance Municipal Income Trust EATON VANCE NATIONAL MUNICIPAL OPPORTUNITIES TRUST
EP$C	# El Paso Corporation Preferred Stock
EPAM	# "EPAM Systems
EPD	# Enterprise Products Partners L.P. Common Stock
EPE	# EP Energy Corporation Class A Common Stock
EPR	# EPR Properties Common Stock
EPR$C	# EPR Properties 5.75% Series C Cumulative Convertible Preferred Shares
EPR$E	# EPR Properties Series E Cumulative Conv Pfd Shs Ser E
EPR$F	# EPR Properties Pfd Ser F
EQC	# Equity Commonwealth Common Shares of Beneficial Interest
EQC$D	# Equity Commonwealth 6.50% Pfd Conv Shs Ser D
EQC$E	# Equity Commonwealth 7.25% Series E Cumulative Redeemable Preferred Shares
EQCO	# Equity Commonwealth 5.75% Senior Notes due 2042
EQM	# "EQT Midstream Partners
EQR	# Equity Residential Common Shares of Beneficial Interest
EQS	# "Equus Total Return
EQT	# EQT Corporation Common Stock
EQY	# "Equity One
ERA	# "Era Group
ERF	# Enerplus Corporation Common Stock
ERJ	# Embraer S.A. Common Stock
EROS	# Eros International PLC A Ordinary Shares
ESD	# Western Asset Emerging Markets Debt Fund Inc Common Stock
ESE	# ESCO Technologies Inc. Common Stock
ESI	# "ITT Educational Services
ESL	# Esterline Technologies Corporation Common Stock
ESNT	# Essent Group Ltd. Common Shares
ESRT	# "Empire State Realty Trust
ESS	# "Essex Property Trust
ESS$H	# "Essex Property Trust
ESV	# Ensco plc Class A Ordinary Shares
ETB	# Eaton Vance Tax
ETE	# "Energy Transfer Equity
ETG	# Eaton Vance Tax
ETH	# Ethan Allen Interiors Inc. Common Stock
ETJ	# Eaton Vance Risk
ETM	# Entercom Communications Corporation Common Stock
ETN	# "Eaton Corporation
ETO	# Eaton Vance Tax
ETP	# "Energy Transfer Partners
ETR	# Entergy Corporation Common Stock
ETV	# Eaton Vance Corporation Eaton Vance Tax
ETW	# Eaton Vance Corporation Eaton Vance Tax
ETX	# Eaton Vance Municipal Income Term Trust Common Shares of Beneficial Interest
ETY	# Eaton Vance Tax
EV	# Eaton Vance Corporation Common Stock
EVC	# Entravision Communications Corporation Common Stock
EVDY	# "Everyday Health
EVER	# EverBank Financial Corp. Common Stock
EVER$A	# EverBank Financial Corp. Depositary Shares Representing 1/1000th Perpetual Preferred Series A
EVF	# Eaton Vance Senior Income Trust Common Stock
EVG	# Eaton Vance Short Diversified Income Fund Eaton Vance Short Duration Diversified Income Fund Common Shares of Beneficial Interest
EVGN	# Evogene Ltd Ordinary shares (Israel)
EVHC	# "Envision Healthcare Holdings
EVN	# Eaton Vance Municipal Income Trust Common Stock
EVR	# Evercore Partners Inc Class A Common Stock
EVT	# Eaton Vance Tax Advantaged Dividend Income Fund Common Shares of Beneficial Interest
EVTC	# "Evertec
EW	# Edwards Lifesciences Corporation Common Stock
EXAM	# "ExamWorks Group
EXAR	# Exar Corporation Common Stock
EXC	# Exelon Corporation Common Stock
EXCU	# Exelon Corp. Conv Unit
EXD	# Eaton Vance Tax
EXG	# Eaton Vance Tax
EXH	# "Exterran Holdings
EXK	# Endeavour Silver Corporation Ordinary Shares (Canada)
EXL	# "Excel Trust
EXL$B	# "Excel Trust
EXP	# Eagle Materials Inc Common Stock
EXPR	# "Express
EXR	# Extra Space Storage Inc Common Stock
EZT	# "Entergy Texas Inc First Mortgage Bonds 5.625% Series due June 1
F	# Ford Motor Company Common Stock
FAC	# First Acceptance Corporation
FAF	# First American Corporation (New) Common Stock
FAM	# First Trust/Aberdeen Global Opportunity Income Fund First Trust/Aberdeen Global Opportunity Income Fund Common Shares of Beneficial Interest
FAV	# First Trust Dividend and Income Fund Common Shares of Beneficial Interest
FBC	# "Flagstar Bancorp
FBHS	# "Fortune Brands Home & Security
FBP	# First BanCorp. New Common Stock
FBR	# Fibria Celulose S.A.
FBS$A	# First Preferred Cap Tr Iv First Preferred Capital Trust IV 8.15% Cum Trust Pfd Sec
FC	# Franklin Covey Company Common Stock
FCAM	# Fiat Chrysler Automobiles N.V. Mandatory Convertible Securities
FCAU	# Fiat Chrysler Automobiles N.V. Common Shares
FCB	# "FCB Financial Holdings
FCE.A	# "Forest City Enterprises
FCE.B	# "Forest City Enterprises
FCF	# First Commonwealth Financial Corporation Common Stock
FCH	# FelCor Lodging Trust Incorporated Common Stock
FCH$A	# FelCor Lodging Trust Incorporated Preferred Stock
FCH$C	# FelCor Lodging Trust Incorporated Dep Shares Representing 1/100 Preferred Series C
FCN	# "FTI Consulting
FCT	# First Trust Senior Floating Rate Income Fund II Common Shares of Beneficial Interest
FCX	# Freeport
FDI	# "Fort Dearborn Income Securities
FDO	# "Family Dollar Stores
FDP	# "Fresh Del Monte Produce
FDS	# FactSet Research Systems Inc. Common Stock
FDX	# FedEx Corporation Common Stock
FE	# FirstEnergy Corporation Common Stock
FEI	# First Trust MLP and Energy Income Fund Common Shares of Beneficial Interest
FELP	# Foresight Energy LP Common Units representing Limited Partner Interests
FENG	# "Phoenix New Media Limited American Depositary Shares
FEO	# First Trust/Aberdeen Emerging Opportunity Fund Common Shares of Beneficial Interest
FET	# "Forum Energy Technologies
FF	# FutureFuel Corp.  Common shares
FFA	# First Trust Enhanced Equity Income Fund
FFC	# Flaherty & Crumrine Preferred Securities Income Fund Incorporated
FFG	# "FBL Financial Group
FGB	# First Trust Specialty Finance and Financial Opportunities Fund
FGL	# Fidelity & Guaranty Life Common Stock
FGP	# "Ferrellgas Partners
FHN	# First Horizon National Corporation Common Stock
FHN$A	# First Horizon National Corporation Depositary Shares
FHY	# First Trust Strategic High Income Fund II First Trust Strategic High Income Fund II Common Shares of Beneficial Interest
FI	# Frank's International N.V. Common Stock
FICO	# Fair Isaac Corproation Common Stock
FIF	# First Trust Energy Infrastructure Fund Common Shares of Beneficial Interest
FIG	# Fortress Investment Group LLC Class A Common Stock
FII	# "Federated Investors
FIS	# "Fidelity National Information Services
FIX	# "Comfort Systems USA
FL	# "Foot Locker
FLC	# Flaherty & Crumrine Total Return Fund Inc Common Stock
FLO	# "Flowers Foods
FLR	# Fluor Corporation Common Stock
FLS	# Flowserve Corporation Common Stock
FLT	# "FleetCor Technologies
FLTX	# Fleetmatics Group PLC Ordinary Shares
FLY	# Fly Leasing Limited
FMC	# FMC Corporation Common Stock
FMD	# First Marblehead Corporation (The) Common Stock
FMER$A	# FirstMerit Corporation Depositary Shares
FMN	# Federated Premier Municipal Income Fund Federated Premier Municipal Income Fund
FMO	# Fiduciary/Claymore MLP Opportunity Fund Fiduciary/Claymore MLP Opportunity Fund Common Shares of Beneficial Interest
FMS	# Fresenius Medical Care AG Common Stock
FMSA	# FMSA Holdings Inc. Common Stock
FMX	# Fomento Economico Mexicano S.A.B. de C.V. Common Stock
FMY	# First Trust Motgage Income Fund Common Shares of Beneficial Interest
FN	# Fabrinet Ordinary Shares
FNB	# F.N.B. Corporation Common Stock
FNB$E	# "F.N.B. Corporation Depositary Shares
FNF	# "FNF Group of Fidelity National Financial
FNFG$B	# First Niagara Financial Group Inc. PFD NON CUM SER B FXD/FLTG
FNFV	# "FNFV Group of Fidelity National Financial
FNV	# Franco
FOE	# Ferro Corporation Common Stock
FOF	# Cohen & Steers Closed
FOR	# Forestar Group Inc Common Stock
FPF	# First Trust Intermediate Duration Preferred & Income Fund Common Shares of Beneficial Interest
FPL	# First Trust New Opportunities MLP & Energy Fund Common Shares of Beneficial Interest
FPO	# First Potomac Realty Trust Common Shares of Beneficial Interest
FPO$A	# First Potomac Realty Trust CUMULATIVE REDEEMABLE PFD PERPETUAL SER A
FPT	# Federated Premier Intermediate Municipal Income Fund Federated Premier Intermediate Municipal Income Fund
FR	# "First Industrial Realty Trust
FRA	# Blackrock Floating Rate Income Strategies Fund Inc  Common Stock
FRC	# FIRST REPUBLIC BANK Common Stock
FRC$A	# First Republicbank Corp DEP SHS REPSTG 1/40TH PERP PFD SER A
FRC$B	# First Republic Bank Depositary Shares Representing 1/40th Perpetual Preferred Series B
FRC$C	# FIRST REPUBLIC BANK Dep Shs Repstg 1/40th Perp Pfd Ser C
FRC$D	# First Republic Bank San Francisco California Depositary Shares Representing 1/40th Perpetual Preferred Series D
FRC$E	# FIRST REPUBLIC BANK Depositary Shs Repstg 1/40th Perp Pfd Ser E Fixed To Fltg (RATE)
FRM	# Furmanite Corporation Common Stock
FRO	# Frontline Ltd. Ordinary Shares
FRT	# Federal Realty Investment Trust Common Stock
FSCE	# Fifth Street Finance Corp. 5.875% Senior Notes due 2024
FSD	# First Trust High Income Long Short Fund Common Shares of Beneficial Interest
FSIC	# FS Investment Corporation Common Stock
FSL	# "Freescale Semiconductor
FSM	# Fortuna Silver Mines Inc Ordinary Shares (Canada)
FSS	# Federal Signal Corporation Common Stock
FT	# Franklin Universal Trust Common Stock
FTI	# "FMC Technologies
FTK	# "Flotek Industries
FTT	# Federated Enhanced Treasury Income Fund Common Shares of Beneficial Interest
FUL	# H. B. Fuller Company Common Stock
FUN	# "Cedar Fair
FUR	# Winthrop Realty Trust New Common Stock
FVE	# "Five Star Quality Care
FXCM	# FXCM Inc. Class A Common Stock
G	# Genpact Limited Common Stock
GAB	# "Gabelli Equity Trust
GAB$D	# "Gabelli Equity Trust
GAB$G	# "Gabelli Equity Trust
GAB$H	# "Gabelli Equity Trust
GAM	# "General American Investors
GAM$B	# "General American Investors Company
GAS	# "AGL Resources
GB	# "Greatbatch
GBAB	# Guggenheim Build America Bonds Managed Duration Trust Common Shares of Beneficial Interest
GBL	# "Gamco Investors
GBX	# "Greenbrier Companies
GCA	# "Global Cash Access Holdings
GCAP	# "GAIN Capital Holdings
GCH	# "Aberdeen Greater China Fund
GCI	# "Gannett Co.
GCO	# Genesco Inc. Common Stock
GCV	# "Gabelli Convertible and Income Securities Fund
GCV$B	# "Gabelli Convertible and Income Securities Fund
GD	# General Dynamics Corporation Common Stock
GDF	# "Western Asset Global Partners Income Fund
GDL	# "GDL Fund
GDL$B	# The GDL Fund Series B Cumulative Puttable and Callable Preferred Shares
GDO	# Western Asset Global Corporate Defined Opportunity Fund Inc. Western Asset Global Corporate Defined Opportunity Fund Inc.
GDOT	# "Green Dot Corporation Class A Common Stock
GDP	# Goodrich Petroleum Corporation Common Stock
GDP$C	# Goodrich Petroleum Corporation Depositary Shares Representing 1/1000th Preferred Series C
GDP$D	# Goodrich Petroleum Corporation Depositary Shares Representing 1/1000th Preferred Series D
GDV	# Gabelli Dividend & Income Trust Common Shares of Beneficial Interest
GDV$A	# Gabelli Dividend & Income Tr Preferred Series A
GDV$D	# Gabelli Dividend Pfd Series D
GE	# General Electric Company Common Stock
GEB	# "General Electric Company 4.875% Notes due October 15
GEF	# Greif Inc. Class A Common Stock
GEF.B	# "Greif
GEH	# "General Electric Capital Corporation 4.876% Notes due January 29
GEK	# "General Electric Capital Corporation 4.70% Notes due May 16
GEL	# "Genesis Energy
GEO	# Geo Group Inc (The) REIT
GEQ	# Guggenheim Equal Weight Enhanced Equity Income Fund Common Shares of Beneficial Interest
GER	# Goldman Sachs MLP Energy Renaissance Fund
GES	# "Guess?
GF	# "New Germany Fund
GFA	# Gafisa SA Gafisa S.A. American Depositary Shares
GFF	# Griffon Corporation Common Stock
GFI	# Gold Fields Limited American Depositary Shares
GFIG	# GFI Group Inc. Common Stock
GFY	# Western Asset Variable Rate Strategic Fund Inc. Common Stock
GG	# Goldcorp Inc. Common Stock
GGB	# Gerdau S.A. Common Stock
GGE	# Guggenheim Enhanced Equity Strategy Fund
GGG	# Graco Inc. Common Stock
GGM	# Guggenheim Credit Allocation Fund Common Shares of Beneficial Interest
GGP	# "General Growth Properties
GGP$A	# "General Growth Properties
GGT	# Gabelli Multi
GGT$B	# Gabelli Multi
GGZ	# Gabelli Global Small and Mid Cap Value Trust (The) Common Shares of Beneficial Interest
GHC	# Graham Holdings Company Common Stock
GHI	# "Global High Income Fund
GHL	# "Greenhill & Co.
GHM	# Graham Corporation Common Stock
GHY	# "Prudential Global Short Duration High Yield Fund
GIB	# "CGI Group
GIL	# "Gildan Activewear
GIM	# "Templeton Global Income Fund
GIMO	# Gigamon Inc. Common Stock
GIS	# "General Mills
GJH	# Synthetic Fixed
GJO	# Synthetic Fixed
GJP	# Synthetic Fixed
GJR	# Synthetic Fixed
GJS	# "Goldman Sachs Group Securities STRATS Trust for Goldman Sachs Group Securities
GJT	# Synthetic Fixed
GJV	# Synthetic Fixed
GLF	# "GulfMark Offshore
GLOB	# Globant S.A. Common Shares
GLOG	# GasLog Ltd. Common Shares
GLOP	# GasLog Partners LP Common Units representing limited partnership interests
GLP	# Global Partners LP Global Partners LP Common Units representing Limited Partner Interests
GLPW	# Global Power Equipment Group Inc Common Stock
GLT	# Glatfelter Common Stock
GLW	# Corning Incorporated Common Stock
GM	# General Motors Company Common Stock
GM.A	# General Motors Company Warrant (Expires 07/10/2016)
GM.B	# General Motors Company Warrant (Expires 07/10/2019)
GM.C	# "General Motors Company Warrants (expiring December 31
GME	# Gamestop Corporation Common Stock
GMED	# "Globus Medical
GMK	# "GRUMA
GMT	# GATX Corporation Common Stock
GMZ	# Goldman Sachs MLP Income Opportunities Fund
GNC	# "GNC Holdings
GNE	# Genie Energy Ltd. Class B Common Stock Stock
GNE$A	# Genie Energy Ltd. Series 2012
GNI	# Great Northern Iron Ore Properties Common Stock
GNRC	# Generac Holdlings Inc. Common Stock
GNT	# "GAMCO Natural Resources
GNW	# Genworth Financial Inc Common Stock
GOF	# Guggenheim Strategic Opportunities Fund Common Shares of Beneficial Interest
GOL	# Gol Linhas Aereas Inteligentes S.A. Sponsored ADR representing Pfd Shares
GOV	# Government Properties Income Trust Common Shares of Beneficial Interest
GPC	# Genuine Parts Company Common Stock
GPE$A	# "Georgia Power Company Georgia Power Company 6 1/8% Series Class A Preferred Stock
GPI	# "Group 1 Automotive
GPK	# Graphic Packaging Holding Company
GPM	# Guggenheim Enhanced Equity Income Fund
GPN	# Global Payments Inc. Common Stock
GPRK	# Geopark Ltd Common Shares
GPS	# "Gap
GPT	# Gramercy Property Trust Inc. Common Stock
GPT$B	# Gramercy Property Trust Inc. Preferred Series B
GPX	# GP Strategies Corporation Common Stock
GRA	# W.R. Grace & Co. Common Stock
GRAM	# "Grana y Montero S.A.A. American Depositary Shares
GRO	# Agria Corporation American Depositary Shares
GRP.U	# "Granite Real Estate Inc. Stapled Units
GRR	# "Asia Tigers Fund
GRT	# Glimcher Realty Trust Common Stock
GRT$G	# Glimcher Realty Trust Preferred Shares of Beneficial Interest Series G
GRT$H	# Glimcher Reatly Tr Pfd Sh Ben Int Ser H %
GRT$I	# Glimcher Realty Trust 6.875% Cumulative Redeemable Preferred Shares of Beneficial Interest
GRUB	# GrubHub Inc. Common Stock
GRX	# The Gabelli Healthcare & Wellness Trust Common Shares of Beneficial Interest
GRX$A	# Gabelli Healthcare PFD SER A
GRX$B	# Gabelli Healthcare Preferred Series B
GS	# "Goldman Sachs Group
GS$A	# "Goldman Sachs Group
GS$B	# "Goldman Sachs Group
GS$C	# "Goldman Sachs Group
GS$D	# "Goldman Sachs Group
GS$I	# "Goldman Sachs Group
GS$J	# Goldman Sachs Group Inc Depositary Shs Repstg 1/1000th Pfd Ser J Fixed to Fltg Rate
GS$K	# "Goldman Sachs Group
GSF	# "Goldman Sachs Group
GSH	# Guangshen Railway Company Limited Common Stock
GSI	# "General Steel Holdings
GSJ	# "Goldman Sachs Group
GSK	# GlaxoSmithKline PLC Common Stock
GSL	# Global Ship Lease Inc New Class A Common Shares
GSL$B	# "Global Ship Lease
GTI	# GrafTech International Ltd (Holding Co.) Common Stock
GTN	# "Gray Communications Systems
GTN.A	# "Gray Television
GTS	# Triple
GTT	# "GTT Communications
GTY	# Getty Realty Corporation Common Stock
GUA	# "Gulf Power Company Series 2011A 5.75% Senior Notes due June 1
GUT	# Gabelli Utility Trust (The) Common Stock
GUT$A	# Gabelli Utility Trust (The) 5.625% Series A Cumulative Preferred Shares
GVA	# Granite Construction Incorporated Common Stock
GWB	# "Great Western Bancorp
GWR	# Genesee & Wyoming Inc. Class A Common Stock
GWRE	# "Guidewire Software
GWRU	# "Genesee & Wyoming
GWW	# "W.W. Grainger
GXP	# Great Plains Energy Incorporated Common Stock
GXP$A	# Great Plains Energy Incorporated Preferred Stock
GXP$D	# Great Plains Energy Incorporated Preferred Stock
GXP$E	# Great Plains Energy Incorporated Preferred Stock
GY	# GenCorp Inc. Common Stock
GYB	# CABCO Series 2004
GYC	# Corporate Asset Backed Corp CABCO Corporate Asset Backed Corporation CABCO Series 2004
GZT	# Gazit
H	# Hyatt Hotels Corporation Class A Common Stock
HAE	# Haemonetics Corporation Common Stock
HAL	# Halliburton Company Common Stock
HAR	# "Harman International Industries
HASI	# "Hannon Armstrong Sustainable Infrastructure Capital
HBI	# Hanesbrands Inc. Common Stock
HBM	# Hudbay Minerals Inc Ordinary Shares (Canada)
HBM.W	# HudBay Minerals Inc Warrants Expiring 07/20/2018 (Canada)
HCA	# "HCA Holdings
HCC	# "HCC Insurance Holdings
HCI	# "HCI Group
HCJ	# "HCI Group
HCLP	# Hi
HCN	# "Health Care REIT
HCN$I	# "Health Care REIT
HCN$J	# HEALTH CARE REIT INC Preferred Stock 6.5% PFD SERIES J
HCP	# "HCP
HD	# "Home Depot
HDB	# HDFC Bank Limited Common Stock
HDY	# HyperDynamics Corporation Common Stock
HE	# "Hawaiian Electric Industries
HE$U	# "Hawaiian Electric Industries
HEI	# Heico Corporation Common Stock
HEI.A	# Heico Corporation Common Stock
HELI	# CHC Group Ltd. Ordinary Shares
HEP	# "Holly Energy Partners
HEQ	# John Hancock Hedged Equity & Income Fund Common Shares of Beneficial Interest
HES	# Hess Corporation Common Stock
HF	# "HFF
HFC	# HollyFrontier Corporation Common Stock
HGG	# "HHGregg
HGH	# "Hartford Financial Services Group
HGR	# "Hanger
HGT	# Hugoton Royalty Trust Common Stock
HHC	# Howard Hughes Corporation (The) Common Stock
HHS	# Harte
HHY	# Brookfield High Income Fund Inc.
HI	# Hillenbrand Inc Common Stock
HIE	# Miller/Howard High Income Equity Fund Common Shares of Beneficial Interest
HIG	# "Hartford Financial Services Group
HIG.W	# "Hartford Financial Services Group
HII	# "Huntington Ingalls Industries
HIL	# "Hill International
HIO	# "Western Asset High Income Opportunity Fund
HIVE	# "Aerohive Networks
HIW	# "Highwoods Properties
HIX	# Western Asset High Income Fund II Inc. Common Stock
HJV	# "MS Structured Asset Corp MS Structured Asset Corp. SATURNS J.C. Penney Company
HK	# Halcon Resources Corporation Common Stock
HL	# Hecla Mining Company Common Stock
HL$B	# Hecla Mining Company Preferred Stock
HLF	# Herbalife Ltd. Common Stock
HLS	# HealthSouth Corporation Common Stock
HLT	# Hilton Worldwide Holdings Inc. Common Stock
HLX	# "Helix Energy Solutions Group
HMC	# "Honda Motor Company
HME	# "Home Properties
HMLP	# Hoegh LNG Partners LP Common Units representing Limited Partner Interests
HMN	# Horace Mann Educators Corporation Common Stock
HMY	# Harmony Gold Mining Company Limited
HNI	# HNI Corporation Common Stock
HNP	# Huaneng Power Intl Common Stock
HNR	# Harvest Natural Resources Inc
HNT	# Health Net Inc. Common Stock
HOG	# Harley
HON	# Honeywell International Inc. Common Stock
HOS	# Hornbeck Offshore Services Common Stock
HOT	# "Starwood Hotels & Resorts Worldwide
HOV	# "Hovnanian Enterprises
HP	# "Helmerich & Payne
HPF	# John Hancock Pfd Income Fund II Pfd Income Fund II
HPI	# John Hancock Preferred Income Fund Common Shares of Beneficial Interest
HPP	# "Hudson Pacific Properties
HPP$B	# "Hudson Pacific Properties
HPQ	# Hewlett
HPS	# John Hancock Preferred Income Fund III Preferred Income Fund III
HPT	# Hospitality Properites Trust Common Stock
HPT$D	# Hospitality Properties Trust Preferred Stock
HPY	# "Heartland Payment Systems
HQH	# Tekla Healthcare Investors Common Stock
HQL	# TeklaLife Sciences Investors Common Stock
HR	# Healthcare Realty Trust Incorporated Common Stock
HRB	# "H&R Block
HRC	# Hill
HRG	# Harbinger Group Inc Common Stock
HRL	# Hormel Foods Corporation Common Stock
HRS	# Harris Corporation Common Stock
HRTG	# "Heritage Insurance Holdings
HSBC	# "HSBC Holdings
HSBC$A	# "HSBC Holdings
HSC	# Harsco Corporation Common Stock
HSEA	# "HSBC Holdings
HSEB	# HSBC Holdings plc PERP SUB CAP SECS EXCH PREF SHS SER 2 (United Kingdom)
HSFC$B	# HSBC Finance Corp Dep. Shares reptsg 1/40 Preferred Series B
HSP	# Hospira Inc
HST	# "Host Hotels & Resorts
HSY	# The Hershey Company Common Stock
HT	# Hersha Hospitality Trust Class A Common Shares of Beneficial Interest
HT$B	# Hersha Hospitality Trust PFD SER B
HT$C	# Hersha Hospitality Trust 6.875% Series C Cumulative Redeemable Preferred Shares of Beneficial Interest
HTA	# "Healthcare Trust of America
HTD	# John Hancock Tax Advantaged Dividend Income Fund Common Shares of Beneficial Interest
HTF	# Horizon Technology Finance Corporation 7.375% Senior Notes due 2019
HTGC	# "Hercules Technology Growth Capital
HTGX	# "Hercules Technology Growth Capital
HTGY	# "Hercules Technology Growth Capital
HTGZ	# "Hercules Technology Growth Capital
HTH	# Hilltop Holdings Inc.
HTR	# Brookfield Total Return Fund Inc. (The) Common Stock
HTS	# Hatteras Financial Corp Hatteras Financial Corp  Common Stock
HTS$A	# Hatteras Financial Corp Cum Redeemable Pfd Ser A
HTY	# John Hancock Tax
HTZ	# "Hertz Global Holdings
HUB.A	# Hubbell Inc A Common Stock
HUB.B	# Hubbell Inc Common Stock Class B
HUBS	# "HubSpot
HUM	# Humana Inc. Common Stock
HUN	# Huntsman Corporation Common Stock
HUSI$D	# "HSBC USA
HUSI$F	# "HSBC USA
HUSI$G	# "HSBC USA
HUSI$H	# "HSBC USA
HUSI$Z	# "HSBC USA
HVB	# Hudson Valley Holding Corp. Common Stock
HVT	# "Haverty Furniture Companies
HVT.A	# "Haverty Furniture Companies
HW	# Headwaters Incorporated Common Stock
HXL	# Hexcel Corporation Common Stock
HY	# Hyster
HYB	# "New America High Income Fund
HYF	# "Managed High Yield Plus Fund
HYH	# "Halyard Health
HYI	# Western Asset High Yield Defined Opportunity Fund Inc. Common Stock
HYT	# "Blackrock Corporate High Yield Fund
HZO	# "MarineMax
I	# Intelsat S.A. Common Shares
I$A	# Intelsat S.A. Series A mandatory convefrtible junior non
IAE	# Voya Asia Pacific High Dividend Equity Income Fund ING Asia Pacific High Dividend Equity Income Fund Common Shares of Beneficial Interest
IAG	# Iamgold Corporation Ordinary Shares
IBA	# "Industrias Bachoco
IBM	# International Business Machines Corporation Common Stock
IBN	# ICICI Bank Limited Common Stock
IBP	# "Installed Building Products
ICA	# Empresas Ica Soc Contrladora Common Stock
ICB	# "MS Income Securities
ICD	# "Independence Contract Drilling
ICE	# Intercontinental Exchange Inc. Common Stock
ICL	# Israel Chemicals Limited Ordinary Shares
IDA	# "IDACORP
IDE	# "Voya Infrastructure
IDG	# ING GROEP N V PREF CTF 7.3750% Perp Hybrid Cap Secs (Netherlands)
IDT	# IDT Corporation Class B Common Stock
IEH	# Integrys Energy Group 6.00% Junior Subordinated Notes Due 2073
IEX	# IDEX Corporation Common Stock
IFF	# "Internationa Flavors & Fragrances
IFN	# "India Fund
IFT	# "Imperial Holdings
IGA	# Voya Global Advantage and Premium Opportunity Fund Common Shares of Beneficial Interest
IGD	# Voya Global Equity Dividend and Premium Opportunity Fund
IGI	# Western Asset Investment Grade Defined Opportunity Trust Inc. Common Stock
IGR	# CBRE Clarion Global Real Estate Income Fund Common Stock
IGT	# International Game Technology Common Stock
IHC	# Independence Holding Company Common Stock
IHD	# Voya Emerging Markets High Income Dividend Equity Fund Common Shares
IHG	# Intercontinental Hotels Group American Depositary Shares (Each representing one Ordinary Share)
IHS	# IHS Inc. IHS Inc. Class A Common Stock
IID	# Voya International High Dividend Equity Income Fund Common Shares of Beneficial Interest
IIF	# "Morgan Stanley India Investment Fund
IIM	# Invesco Value Municipal Income Trust Common Stock
IL	# "IntraLinks Holdings
IM	# Ingram Micro Inc. Common Stock
IMAX	# Imax Corporation Common Stock
IMN	# Imation Corporation Common Stock
IMPR	# "Imprivata
IMPV	# "Imperva
IMS	# "IMS Health Holdings
INB	# "Cohen & Steers Global Income Builder
IND	# "ING Group
INF	# Brookfield Global Listed Infrastructure Income Fund Closed End Fund
INFY	# Infosys Limited American Depositary Shares
ING	# "ING Group
INGR	# Ingredion Incorporated Common Stock
INN	# "Summit Hotel Properties
INN$A	# "Summit Hotel Properties
INN$B	# "Summit Hotel Properties
INN$C	# "Summit Hotel Properties
INT	# World Fuel Services Corporation Common Stock
INVN	# "InvenSense
INXN	# InterXion Holding N.V. Ordinary Shares (0.01 nominal value)
INZ	# Ing Groep NV Perpetual Debt Securities
IO	# Ion Geophysical Corporation Common Stock
IOC	# InterOil Corporation
IP	# International Paper Company Common Stock
IPG	# "Interpublic Group of Companies
IPHI	# Inphi Corporation Common Stock $0.001 par value
IPI	# "Intrepid Potash
IPL$D	# Interstate Power & Light Company Perp Prd Ser D
IQI	# Invesco Quality Municipal Income Trust Common Stock
IR	# Ingersoll
IRC	# Inland Real Estate Corporation Common Stock
IRC$A	# "Inland Real Estate Corporation 8.125% Series A Cumulative Redeemable Preferred Stock
IRC$B	# Inland Real Estate Corporation Redeemable Preferred Series B
IRE	# Governor and Company of the Bank of Ireland (The) Common Stock
IRET	# Investors Real Estate Trust Shares of Beneficial Interest
IRET$	# Investors Real Estate Trust Series A Cumulative Redeemable Preferred Shares of Beneficial Interest
IRET$B	# Investors Real Estate Trust 7.95% Series B Cumulative Redeemable Preferred Shares
IRF	# International Rectifier Corporation Common Stock
IRL	# "New Ireland Fund
IRM	# Iron Mountain Incorporated (Delaware)Common Stock
IRR	# Voya Natural Resources Equity Income Fund Common Shares of Beneficial Interest
IRS	# IRSA Inversiones Y Representaciones S.A. Common Stock
ISD	# "Prudential Short Duration High Yield Fund
ISF	# "ING Group
ISG	# "ING Group
ISH	# International Shipholding Corporation Common Stock
ISH$A	# International Shipholding Corporation Cumulative Redeemable Perpetual Preferred Series A
ISH$B	# International Shipholding Corporation PERP PFD SER B
ISP	# ING Groep NV 6.20% Perpetual Debt Securities (Netherlands)
IT	# "Gartner
ITC	# ITC Holdings Corp. Common Stock
ITG	# "Investment Technology Group
ITT	# ITT Corporation Common Stock New
ITUB	# Itau Unibanco Banco Holding SA American Depositary Shares (Each repstg 500 Preferred shares)
ITW	# Illinois Tool Works Inc. Common Stock
IVC	# Invacare Corporation Common Stock
IVH	# Ivy High Income Opportunities Fund Common Shares of Beneficial Interest
IVR	# INVESCO MORTGAGE CAPITAL INC Common Stock
IVR$A	# Invesco Mortgage Capital Inc. Pfd Ser A
IVR$B	# Invesco Mortgage Capital Inc. Preferred Series B Cum Fxd to Fltg
IVZ	# Invesco Plc New Common Stock
IX	# Orix Corp Ads Common Stock
JAH	# Jarden Corporation Common Stock
JBK	# Lehman ABS 3.50 3.50% Adjustable Corp Backed Tr Certs GS Cap I
JBL	# "Jabil Circuit
JBN	# "Select Asset Inc. Select Asset Inc. on behalf of Corporate Backed Callable Trust Certificates
JBR	# "Select Asset Inc. Corporate Backed Callable Trust Certificates
JBT	# John Bean Technologies Corporation Common Stock
JCE	# Nuveen Core Equity Alpha Fund Nuveen Core Equity Alpha Fund Common Shares of Beneficial Interest
JCI	# "Johnson Controls
JCP	# "J.C. Penney Company
JDD	# Nuveen Diversified Dividend and Income Fund Shares of Beneficial Interest
JE	# "Just Energy Group
JEC	# Jacobs Engineering Group Inc. Common Stock
JEQ	# "Aberdeen Japan Equity Fund
JFC	# "JPMorgan China Region  Fund
JFR	# Nuveen Floating Rate Income Fund Common Stock
JGH	# Nuveen Global High Income Fund Common Shares of Beneficial Interest
JGV	# Nuveen Global Equity Income Fund
JGW	# J.G. Wentworth Company (The) Class A Common Stock
JHI	# John Hancock Investors Trust Common Stock
JHP	# Nuveen Quality Preferred Income Fund 3 Preferred Income 3
JHS	# John Hancock Income Securities Trust Common Stock
JHX	# James Hardie Industries plc American Depositary Shares (Ireland)
JKS	# JinkoSolar Holding Company Limited American Depositary Shares (each representing 4 Common Shares)
JLL	# Jones Lang LaSalle Incorporated Common Stock
JLS	# Nuveen Mortgage Opportunity Term Fund Nuveen Mortgage Opportunity Term Fund
JMEI	# "Jumei International Holding Limited American Depositary Shares
JMF	# Nuveen Energy MLP Total Return Fund Common Shares of Beneficial Interest
JMI	# Javelin Mortgage Investment Corp. Common Stock
JMLP	# Nuveen All Cap Energy MLP Opportunities Fund Common Shares of Beneficial Interest
JMM	# Nuveen Multi
JMP	# JMP Group LLC Common Shares
JMPB	# JMP Group Inc 8.00% Senior Notes due 2023
JMPC	# JMP Group Inc 7.25% Senior Notes due 2021
JMT	# Nuveen Mortgage Opportunity Term Fund 2 Common Shares of Beneficial Interest
JNJ	# Johnson & Johnson Common Stock
JNPR	# "Juniper Networks
JNS	# "Janus Capital Group
JOE	# St. Joe Company (The) Common Stock
JOF	# Japan Smaller Capitalization Fund Inc Common Stock
JONE	# "Jones Energy
JOY	# Joy Global Inc. Common Stock
JPC	# Nuveen  Preferred Income Opportunities Fund
JPEP	# JP Energy Partners LP Common units representing limited partner interests
JPI	# Nuveen Preferred and Income Term Fund Common Shares of Beneficial Interest
JPM	# JP Morgan Chase & Co. Common Stock
JPM$A	# J P Morgan Chase & Co Depositary Shs Repstg 1/400 Pfd Ser P
JPM$B	# JP Morgan Chase & Co Depositary Shares Representing 1/400th Preferred Series T
JPM$C	# "JPMorgan Chase Capital XXIX 6.70% Capital Securities
JPM$D	# JPMorgan Chase Bank N A London Branch Depositary Shs Repstg 1/400th Pfd Ser O
JPM$E	# J P Morgan Chase & Co Depository Shares Representing 1/400th Int Perp Pfd Ser W
JPM.W	# "J P Morgan Chase & Co Warrant expiring October 28
JPS	# Nuveen Quality Preferred Income Fund 2 Shares of Beneficial Interest
JPW	# Nuveen Flexible Investment Income Fund Common Shares of Beneficial Interest
JQC	# Nuveen Credit Strategies Income Fund Shares of Beneficial Interest
JRI	# Nuveen Real Asset Income and Growth Fund Common Shares of Beneficial Interest
JRN	# "Journal Communications
JRO	# Nuveen Floating Rate Income Opportuntiy Fund Shares of Beneficial Interest
JSD	# Nuveen Short Duration Credit Opportunities Fund Common Shares of Beneficial Interest
JTA	# Nuveen Tax
JTD	# Nuveen Tax
JTP	# Nuveen Quality Preferred Income Fund Shares of Beneficial Interest
JW.A	# "John Wiley & Sons
JW.B	# "John Wiley & Sons
JWN	# "Nordstrom
K	# Kellogg Company Common Stock
KAI	# Kadant Inc Common Stock
KAMN	# Kaman Corporation Common Stock
KAP	# "KCAP Financial
KAR	# "KAR Auction Services
KATE	# Kate Spade & Company Common Stock
KB	# KB Financial Group Inc
KBH	# KB Home Common Stock
KBR	# "KBR
KCC	# Structured Products Corp. 8.20% Corporate Backed Trust Securities (CorTS)Issued by Provident Financial Trust I
KCG	# "KCG Holdings
KED	# Kayne Anderson Energy Development Company Common Stock
KEF	# "Korea Equity Fund
KEG	# "Key Energy Services
KEM	# Kemet Corporation New Common Stock
KEN.V	# Kenon Holdings Ltd. Ordinary Shares When Issued
KEP	# Korea Electric Power Corporation Common Stock
KEX	# Kirby Corporation Common Stock
KEY	# KeyCorp Common Stock
KEY$G	# KeyCorp Non Cumulative Perp Conv Pfd Ser A
KEYS	# Keysight Technologies Inc. Common Stock
KF	# "Korea Fund
KFH	# KKR Financial Holdings LLC 8.375% Senior Notes due 2041
KFI	# KKR Financial Holdings LLC 7.50% Senior Notes due 2042
KFN$	# KKR Financial Holdings LLC Pfd Ser A Llc
KFS	# "Kingsway Financial Services
KFY	# Korn/Ferry International Common Stock
KGC	# Kinross Gold Corporation Common Stock
KHI	# Deutsche High Income Trust Shares of Beneficial Interest
KIM	# Kimco Realty Corporation Common Stock
KIM$H	# Kimco Realty Corporation Depositary Shares Representing 1/100 Shares of Redeemable Preferred Class H
KIM$I	# Kimco Realty Corporation DEPOSITARY SH REPSTG 1/1000TH PFD SER I
KIM$J	# Kimco Realty Corporation Depositary Sh Repstg 1/1000th Pfd CL J %
KIM$K	# Kimco Realty Corporation Depositary Shares Representing 1/1000th Preferred Series K
KING	# King Digital Entertainment plc Ordinary Share
KIO	# KKR Income Opportunities Fund Common Shares
KKD	# "Krispy Kreme Doughnuts
KKR	# KKR & Co. L.P. Common Units Representing Limited Partnership Interest
KMB	# Kimberly
KMF	# "Kayne Anderson Midstream Energy Fund
KMG	# "KMG Chemicals
KMI	# "Kinder Morgan
KMI.W	# "Kinder Morgan
KMM	# Deutsche  Multi
KMPA	# Kemper Corporation 7.375% Subordinated Debentures due 2054
KMPR	# Kemper Corporation
KMT	# Kennametal Inc. Common Stock
KMX	# CarMax Inc
KN	# Knowles Corporation Common Stock
KND	# "Kindred Healthcare
KNL	# "Knoll
KNM	# Konami Corporation American Depositary Shares (Each repstg one share of Common Stock)
KNOP	# KNOT Offshore Partners LP Common Units representing Limited Partner Interests
KNX	# "Knight Transportation
KO	# Coca
KODK	# Eastman Kodak Company Common New
KODK.A	# Eastman Kodak Company Wt Exp 135%
KODK.W	# "Eastman Kodak Company Warrant (Expiring September 3
KOF	# Coca Cola Femsa S.A.B. de C.V.  Common Stock
KOP	# Koppers Holdings Inc. Koppers Holdings Inc. Common Stock
KORS	# Michael Kors Holdings Limited Ordinary Shares
KOS	# Kosmos Energy Ltd. Common Shares
KR	# Kroger Company (The) Common Stock
KRA	# "Kraton Performance Polymers
KRC	# Kilroy Realty Corporation Common Stock
KRC$G	# Kilroy Realty Corporation Preferred Stock Series G
KRC$H	# Kilroy Realty Corporation Pfd Ser H
KRG	# Kite Realty Group Trust Common Stock
KRG$A	# Kite Realty Group Trust PERP PFD SER A
KRO	# Kronos Worldwide Inc Common Stock
KS	# KapStone Paper and Packaging Corporation Common Stock
KSM	# Deutsche Strategic Municiple Income Trust Common Shares of Beneficial Interest
KSS	# Kohl's Corporation Common Stock
KST	# Deutsche Strategic Income Trust Shares of Beneficial Interest
KSU	# Kansas City Southern Common Stock
KSU$	# Kansas City Southern Preferred Stock
KT	# KT Corporation Common Stock
KTF	# Deutsche Municiple Income Trust Common Shares
KTH	# Structures Products Cp 8% CorTS Issued by Peco Energy Cap Tr II Preferred Stock
KTN	# Structured Products Corp 8.205% CorTS 8.205% Corporate Backed Trust Securities (CorTS)
KTP	# Corts 7.625 Pfd Common Stock
KW	# Kennedy
KWN	# Kennedy
KWR	# Quaker Chemical Corporation Common Stock
KYE	# "Kayne Anderson Total Energy Return Fund
KYN	# Kayne Anderson MLP Investment Company Common Stock
KYN$E	# "Kayne Anderson MLP Investment Company Series E Mandatory Redeemable Preferred Shares
KYN$F	# Kayne Anderson MLP Investment Company 3.50% Series F Mandatory Redeemable Preferred Shares $25.00 Liquidation Preference per share
KYN$G	# Kayne Anderson MLP Investment Company Series G Mandatory Redeemable Preferred Shares Liquidation Preference
KYO	# Kyocera Corporation Common Stock
L	# Loews Corporation Common Stock
LAD	# "Lithia Motors
LADR	# Ladder Capital Corp Class A Common Stock
LAS	# "Lentuo International Inc. American Depositary Shares
LAZ	# "Lazard LTD. Lazard
LB	# "L Brands
LBF	# "Deutsche Global High Income Fund
LC	# LendingClub Corporation Common Stock
LCI	# Lannett Co Inc Common Stock
LCM	# Advent/Claymore Enhanced Growth & Income Fund Advent/Claymore Enhanced Growth & Income Fund Common Shares of Beneficial Interest
LDF	# "Latin American Discovery Fund
LDL	# "Lydall
LDOS	# "Leidos Holdings
LDP	# "Cohen & Steers Limited Duration Preferred and Income Fund
LDR	# "Landauer
LEA	# Lear Corporation Common Stock
LEAF	# "Springleaf Holdings
LEE	# "Lee Enterprises
LEG	# "Leggett & Platt
LEJU	# "Leju Holdings Limited American Depositary Shares
LEN	# Lennar Corporation Class A Common Stock
LEN.B	# Lennar Corporation Class B
LEO	# "Dreyfus Strategic Municipals
LEU	# Centrus Energy Corp. Class A Common Stock
LF	# Leapfrog Enterprises Inc Common Stock
LFC	# China Life Insurance Company Limited American Depositary Shares
LFL	# LATAM Airlines Group S.A.
LG	# Laclede Gas Company Common Stock
LGF	# Lions Gate Entertainment Corporation Common Stock
LGI	# Lazard Global Total Return and Income Fund Common Stock
LH	# Laboratory Corporation of America Holdings Common Stock
LHO	# LaSalle Hotel Properties Common Stock
LHO$H	# LaSalle Hotel Properties 7.50% Series H Cumulative Redeemable Preferred Shares of Beneficial Interest
LHO$I	# LaSalle Hotel Properties 6.375% Series I Cumulative Redeemable Redeemable Preferred SBI
LII	# "Lennox International
LITB	# "LightInTheBox Holding Co.
LL	# "Lumber Liquidators Holdings
LLL	# L
LLY	# Eli Lilly and Company Common Stock
LM	# "Legg Mason
LMT	# Lockheed Martin Corporation Common Stock
LNC	# Lincoln National Corporation Common Stock
LNC.W	# "Lincoln National Corporation Warrant expiring July 10
LND	# Brasilagro Brazilian Agric Real Estate Co Sponsored ADR (Brazil)
LNKD	# LinkedIn Corporation Class A Common Stock
LNN	# Lindsay Corporation Common Stock
LNT	# Alliant Energy Corporation Common Stock
LO	# "Lorillard
LOCK	# "LifeLock
LOR	# "Lazard World Dividend & Income Fund
LOW	# "Lowe's Companies
LPG	# Dorian LPG Ltd. Common Stock
LPI	# "Laredo Petroleum
LPL	# "LG Display Co
LPT	# Liberty Property Trust
LPX	# Louisiana
LQ	# La Quinta Holdings Inc. Common Stock
LRE	# "LRR Energy
LRN	# K12 Inc Common Stock
LTC	# "LTC Properties
LTM	# Life Time Fitness Common Stock
LUB	# "Luby's
LUK	# Leucadia National Corporation Common Stock
LUV	# Southwest Airlines Company Common Stock
LUX	# "Luxottica Group
LVLT	# "Level 3 Communications
LVS	# Las Vegas Sands Corp. Common Stock
LXFR	# Luxfer Holdings PLC American Depositary Shares (each representing one
LXFT	# "Luxoft Holding
LXK	# "Lexmark International
LXP	# Lexington Realty Trust Common Stock
LXP$C	# Lexington Realty Trust  Preferred Conv. Series C
LXU	# "LSB Industries
LYB	# LyondellBasell Industries NV Ordinary Shares Class A (Netherlands)
LYG	# Lloyds Banking Group Plc American Depositary Shares
LYG$A	# "Lloyds Banking Group Plc 7.75% Public Income NotES (PINES) due July 15
LYV	# "Live Nation Entertainment
LZB	# La
M	# Macy's Inc Common Stock
MA	# Mastercard Incorporated Common Stock
MAA	# Mid
MAC	# Macerich Company (The) Common Stock
MAIN	# Main Street Capital Corporation Common Stock
MAN	# ManpowerGroup Common Stock
MANU	# Manchester United Ltd. Class A Ordinary Shares
MAS	# Masco Corporation Common Stock
MATX	# "Matson
MAV	# Pioneer Municipal High Income Advantage Trust Common Shares of Beneficial Interest
MBI	# MBIA Inc. Common Stock
MBLY	# Mobileye N.V. Ordinary Shares
MBT	# Mobile TeleSystems OJSC
MC	# Moelis & Company Class A Common Stock
MCA	# "Blackrock MuniYield California Quality Fund
MCC	# Medley Capital Corporation Common Stock
MCD	# McDonald's Corporation Common Stock
MCI	# Babson Capital Corporate Investors Common Stock
MCK	# McKesson Corporation Common Stock
MCN	# Madison Covered Call & Equity Strategy Fund Common Stock
MCO	# Moody's Corporation Common Stock
MCP	# "Molycorp
MCQ	# Medley Capital Corporation 7.125% Senior Notes due 2019
MCR	# MFS Charter Income Trust Common Stock
MCS	# Marcus Corporation (The) Common Stock
MCV	# Medley Capital Corporation 6.125% Senior Notes due 2023
MCY	# Mercury General Corporation Common Stock
MD	# "Mednax
MDC	# "M.D.C. Holdings
MDLY	# Medley Management Inc. Class A Common Stock
MDP	# Meredith Corporation Common Stock
MDR	# "McDermott International
MDT	# Medtronic Inc. Common Stock
MDU	# "MDU Resources Group
MED	# MEDIFAST INC Common Stock
MEG	# "Media General
MEI	# "Methode Electronics
MEN	# "Blackrock MuniEnhanced Fund
MEP	# "Midcoast Energy Partners
MER$D	# "Merrill Lynch & Co.
MER$E	# "Merrill Lynch & Co.
MER$F	# "Merrill Lynch & Co.
MER$K	# "Merrill Lynch & Co.
MER$M	# "Merrill Lynch & Co.
MER$P	# "Merrill Lynch & Co.
MET	# "MetLife
MET$A	# "MetLife
MET$B	# "MetLife
MFA	# "MFA Financial
MFA$B	# "MFA Financial
MFC	# Manulife Financial Corporation Common Stock
MFD	# Macquarie/First Trust Global Common Stock
MFG	# "Mizuho Financial Group
MFL	# Blackrock MuniHoldings Investment Quality Fund Common Shares of Beneficial Interest
MFM	# MFS Municipal Income Trust Common Stock
MFO	# "MFA Financial
MFT	# Blackrock MuniYield Investment Quality Fund Common Shares of Beneficial Interest
MFV	# MFS Special Value Trust Common Stock
MG	# Mistras Group Inc Common Stock
MGA	# "Magna International
MGF	# MFS Government Markets Income Trust Common Stock
MGM	# MGM Resorts International Common Stock
MGR	# "Affiliated Managers Group
MGU	# Macquarie Global Infrastructure Total Return Fund Inc. Common Stock
MH$A	# "Maiden Holdings
MHD	# "Blackrock MuniHoldings Fund
MHF	# "Western Asset Municipal High Income Fund
MHFI	# "McGraw Hill Financial
MHG	# Marine Harvest ASA Sponsored ADR (Norway)
MHI	# Pioneer Municipal High Income Trust Common Shares of Beneficial Interest
MHK	# "Mohawk Industries
MHN	# "Blackrock MuniHoldings New York Quality Fund
MHNA	# Maiden Holdings North America Ltd. 8.25% Notes due 2041
MHNB	# "Maiden Holdings North America
MHNC	# "Maiden Holdings North America
MHO	# "M/I Homes
MHO$A	# "M/I Homes
MHR	# Magnum Hunter Resources Corporation
MHY	# "Western Asset Managed High Income Fund
MIC	# Macquarie Infrastructure Company LLC (New) Shares representing one Limited Liability Interest
MIE	# "Cohen & Steers MLP Income and Energy Opportunity Fund
MIG	# "Meadowbrook Insurance Group
MIL	# MFC Industrial Ltd.
MILL	# "Miller Energy Resourses
MILL$C	# "Miller Energy Resources
MILL$D	# "Miller Energy Resources
MIN	# MFS Intermediate Income Trust Common Stock
MITT	# "AG Mortgage Investment Trust
MITT$A	# "AG Mortgage Investment Trust
MITT$B	# "AG Mortgage Investment Trust
MIXT	# "MiX Telematics Limited American Depositary Shares
MIY	# "Blackrock MuniYield Michigan Quality Fund
MJI	# "Blackrock MuniYield New Jersey Quality Fund
MJN	# Mead Johnson Nutrition Company Common Stock
MKC	# "McCormick & Company
MKC.V	# "McCormick & Company
MKL	# Markel Corporation Common Stock
MLI	# "Mueller Industries
MLM	# "Martin Marietta Materials
MLP	# "Maui Land & Pineapple Company
MLR	# "Miller Industries
MM	# "Millennial Media
MMC	# "Marsh & McLennan Companies
MMD	# MainStay DefinedTerm Municipal Opportunities Fund Common Shares of Beneficial Interest
MMI	# "Marcus & Millichap
MMM	# 3M Company Common Stock
MMP	# Magellan Midstream Partners L.P. Limited Partnership
MMS	# "Maximus
MMT	# MFS Multimarket Income Trust Common Stock
MMU	# "Western Asset Managed Municipals Fund
MN	# "Manning & Napier
MNE	# Blackrock Muni New York Intermediate Duration Fund Inc Common Stock
MNI	# McClatchy Company (The) Common Stock
MNK	# Mallinckrodt plc Ordinary Shares
MNP	# "Western Asset Municipal Partners Fund
MNR	# Monmouth Real Estate Investment Corporation Class A Common Stock
MNR$A	# Monmouth Real Estate Investment Corporation 7.625% Series A Cumulative Redeemable Preferred Stock
MNR$B	# Monmouth Real Estate Investment Corporation Series B Cumulative Redeemable Preferred Stock $0.01 par value
MO	# "Altria Group
MOD	# Modine Manufacturing Company Common Stock
MODN	# "Model N
MOG.A	# Moog Inc. Class A Common Stock
MOG.B	# Moog Inc. Class B Common Stock
MOH	# Molina Healthcare Inc Common Stock
MON	# Monsanto Company Common Stock
MORE	# "Monogram Residential Trust
MOS	# Mosaic Company (The) Common Stock
MOV	# Movado Group Inc. Common Stock
MP$D	# Mississippi Power Company 5.25 Srs Pfd
MPA	# Blackrock MuniYield Pennsylvania Quality Fund Common Stock
MPC	# Marathon Petroleum Corporation Common Stock
MPG	# Metaldyne Performance Group Inc. Common Stock
MPLX	# MPLX LP Common Units Representing Limited Partner Interests
MPO	# "Midstates Petroleum Company
MPV	# Babson Capital Participation Investors Common Stock
MPW	# "Medical Properties Trust
MPX	# Marine Products Corporation Common Stock
MQT	# "Blackrock MuniYield Quality Fund II
MQY	# "Blackrock MuniYield Quality Fund
MR	# Mindray Medical International Limited Sponsored ADR representing Class A shares (China)
MRC	# MRC Global Inc. Common Stock
MRH	# Montpelier Re Holdings Ltd.
MRH$A	# Montpelier RE Holdings Ltd Non Cumulative Series A Preferred Shares (Bermuda)
MRIN	# Marin Software Incorporated Common Stock
MRK	# "Merck & Company
MRO	# Marathon Oil Corporation Common Stock
MS	# Morgan Stanley Common Stock
MS$A	# Morgan Stanley Dep Shs repstg 1/1000 Pfd Ser A
MS$E	# Morgan Stanley DEPOSITARY SHARES REP 1/1000TH SHARES FIXED/FLTG PREFERRED STOCK SERIES E
MS$F	# Morgan Stanley Dep Shs Rpstg 1/1000th Int Prd Ser F Fxd to Flag
MS$G	# Morgan Stanley Depositary Shares Representing 1/1000th Preferred Series G
MS$I	# Morgan Stanley Depository Shares Representing 1/1000th Preferred Series 1 Fixed to Floating Non (Cum)
MSA	# MSA Safety Incorporated Common Stock
MSB	# Mesabi Trust Common Stock
MSCA	# Main Street Capital Corporation 6.125% Senior Notes due 2023
MSCI	# MSCI Inc Common Stock
MSD	# "Morgan Stanley Emerging Markets Debt Fund
MSF	# "Morgan Stanley Emerging Markets Fund
MSI	# "Motorola Solutions
MSJ	# Morgan Stanley Cap Trust VI Cap Securities
MSK	# Morgan Stanley Cap TR VIII GDT Cap Securities
MSL	# MidSouth Bancorp Common Stock
MSM	# "MSC Industrial Direct Company
MSO	# "Martha Stewart Living Omnimedia
MSP	# Madison Strategic Sector Premium Fund Madison Strategic Sector Premium Fund Common Shares of Beneficial Interest
MSZ	# Morgan Stanley Capital Trust VII Cap Secs
MT	# Arcelor Mittal NY Registry Shares NEW
MTB	# M&T Bank Corporation Common Stock
MTB$	# "M&T Bank Corporation Fixed Rate Cumulative Perpetual Preferred Stock
MTB$C	# "M&T Bank Corporation Fixed Rate Cumulative Perpetual Preferred Stock
MTB.W	# "M&T Bank Corporation Warrant (Expiring December 23
MTCN	# ArcelorMittal 6.00% Mandatorily Convertible Subordinated Notes due 2016
MTD	# Mettler
MTDR	# Matador Resources Company Common Stock
MTG	# MGIC Investment Corporation Common Stock
MTH	# Meritage Homes Corporation Common Stock
MTL	# Mechel OAO American Depositary Shares (Each rep. 1 common shares)
MTL$	# Mechel Steel Group OAO American Depositary Shares (each representing one
MTN	# "Vail Resorts
MTOR	# "Meritor
MTR	# Mesa Royalty Trust Common Stock
MTRN	# Materion Corporation
MTS	# "Montgomery Street Income Securities
MTT	# Western Asset Municipal Defined Opportunity Trust Inc Common Stock
MTU	# "Mitsubishi UFJ Financial Group
MTW	# "Manitowoc Company
MTX	# Minerals Technologies Inc. Common Stock
MTZ	# "MasTec
MUA	# "Blackrock MuniAssets Fund
MUC	# "Blackrock MuniHoldings California Quality Fund
MUE	# "Blackrock MuniHoldings Quality Fund II
MUH	# "Blackrock MuniHoldings Fund II
MUI	# Blackrock Muni Intermediate Duration Fund Inc Common Stock
MUJ	# "Blackrock MuniHoldings New Jersey Quality Fund
MUR	# Murphy Oil Corporation Common Stock
MUS	# "Blackrock MuniHoldings Quality Fund
MUSA	# Murphy USA Inc. Common Stock
MUX	# McEwen Mining Inc. Common Stock
MVC	# "MVC Capital
MVCB	# MVC Capital 7.25% Senior Notes due 2023
MVNR	# "Mavenir Systems
MVO	# MV Oil Trust Units of Beneficial Interests
MVT	# "Blackrock MuniVest Fund II
MW	# "Men's Wearhouse
MWA	# MUELLER WATER PRODUCTS Common Stock
MWE	# "MarkWest Energy Partners
MWG	# Morgan Stanley Cap Tr IV Gtd Cap Secs
MWO	# Morgan Stanley Cap Tr V Gtd Cap Secs
MWR	# Morgan Stanley Cap Tr III Capital Trust Securities
MWV	# Meadwestvaco Corporation Common Stock
MWW	# "Monster Worldwide
MX	# "MagnaChip Semiconductor Corporation Depositary Shares
MXE	# "Mexico Equity and Income Fund
MXF	# "Mexico Fund
MXL	# "MaxLinear
MY	# "China Ming Yang Wind Power Group Limited American Depositary Shares
MYC	# "Blackrock MuniYield California Fund
MYCC	# "ClubCorp Holdings
MYD	# "Blackrock MuniYield Fund
MYE	# "Myers Industries
MYF	# Blackrock MuniYield Investment Fund Common Stock
MYI	# "Blackrock MuniYield Quality Fund III
MYJ	# "Blackrock MuniYield New Jersey Fund
MYM	# "Blackrock MuniYield Michigan Quality Fund II
MYN	# "Blackrock MuniYield New York Quality Fund
MZF	# Managed Duration Investment Grade Municipal Fund
N	# Netsuite Inc Common Stock
NAC	# Nuveen California Dividend Advantage Municipal Fund Common Stock
NAD	# Nuveen Dividend Advantage Municipal Fund Common Stock
NADL	# North Atlantic Drilling Ltd. Common Shares
NAN	# Nuveen New York Dividend Advantage Municipal Fund Common Stock
NAO	# Nordic Amern Offshore Ltd Ordinary Shares Reg S (Marshall Islands)
NAP	# Navios Maritime Midstream Partners LP Common Units representing limited partner interests
NAT	# Nordic American Tankers Limited Common Stock
NAV	# Navistar International Corporation Common Stock
NAV$D	# Navistar International Corporation Preferred Stock
NAZ	# Nuveen Arizona Premium Income Municipal Fund Common Stock
NBB	# Nuveen Build America Bond Fund Common Shares of Beneficial Interest
NBD	# Nuveen Build America Bond Opportunity Fund Common Shares of Beneficial Interest
NBG	# Natl Bk Greece American Depositary Shares
NBG$A	# National Bank of Greece SA Sponsored ADR representing Series A Preferred Shares (Greece)
NBHC	# National Bank Holdings Corporation Common Stock
NBL	# Noble Energy Inc. Common Stock
NBR	# Nabors Industries Ltd.
NC	# "NACCO Industries
NCA	# "Nuveen California Municipal Value Fund
NCFT	# "Norcraft Companies
NCI	# "Navigant Consulting
NCR	# NCR Corporation Common Stock
NCS	# "NCI Building Systems
NCT	# Newcastle Investment Corporation
NCT$B	# Newcastle Investment Corporation Preferred Series B
NCT$C	# Newcastle Investment Corporation Preferred Series C
NCT$D	# Newcastle Invt Corp New PFD Ser D%
NCV	# AllianzGI Convertible & Income Fund
NCZ	# AllianzGI Convertible & Income Fund II Common Shares of Beneficial Interest
NDP	# "Tortoise Energy Independence Fund
NDRO	# Enduro Royalty Trust Trust Units representing beneficial interest in the trust
NE	# Noble Corporation Ordinary Shares (UK)
NEA	# Nuveen AMT
NEE	# "NextEra Energy
NEE$C	# "FPL Group
NEE$G	# "NextEra Energy
NEE$H	# "NextEra Energy
NEE$I	# "NextEra Energy
NEE$J	# "NextEra Energy
NEE$O	# "NextEra Energy
NEE$P	# "NextEra Energy
NEFF	# Neff Corporation Common Stock
NEM	# Newmont Mining Corporation
NEP	# "NextEra Energy Partners
NES	# "Nuverra Environmental Solutions
NEU	# NewMarket Corp Common Stock
NEV	# Nuveen Enhanced Municipal Value Fund Common Shares of Beneficial Interest
NEWM	# New Media Investment Group Inc. Common Stock
NEWR	# "New Relic
NFG	# National Fuel Gas Company Common Stock
NFJ	# "AllianzGI NFJ Dividend
NFX	# Newfield Exploration Company Common Stock
NGG	# "National Grid Transco
NGL	# NGL ENERGY PARTNERS LP Common Units representing Limited Partner Interests
NGLS	# Targa Resources Partners LP Common Units Representing Limited Partnership Interests
NGS	# "Natural Gas Services Group
NGVC	# "Natural Grocers by Vitamin Cottage
NHF	# NexPoint Credit Strategies Fund
NHI	# "National Health Investors
NI	# NiSource Inc Common Stock
NID	# Nuveen Intermediate Duration Municipal Term Fund Common Shares of Beneficial Interest
NIE	# AllianzGI Equity & Convertible Income Fund
NIM	# Nuveen Select Maturities Municipal Fund Common Stock
NIO	# "Nuveen Municipal Opportunity Fund
NIQ	# Nuveenn Intermediate Duration Quality Municipal Term Fund Common Shares of Beneficial Interest
NJ	# Nidec Corporation (Nihon Densan Kabushiki Kaisha) American Depositary Shares
NJR	# NewJersey Resources Corporation Common Stock
NKA	# Niska Gas Storage Partners LLC Common Units Representing Limited Liability Company Interests
NKE	# "Nike
NKG	# Nuveen Georgia Dividend Advantage Municipal Fund 2 Nuveen Georgia Dividend Advantage Municipal Fund 2 (the
NKX	# Nuveen California AMT
NL	# "NL Industries
NLS	# "Nautilus
NLSN	# Nielsen N.V. Common Stock
NLY	# Annaly Capital Management Inc Common Stock
NLY$A	# Annaly Capital Management Inc Preferred Stock Series A
NLY$C	# Annaly Capital Management Inc 7.625% Series C Cumulative Redeemable Preferred Stock
NLY$D	# Annaly Capital Management Inc Preferred Series D
NM	# Navios Maritime Holdings Inc. Common Stock
NM$G	# Navios Maritime Holdings Inc. Sponsored ADR Representing 1/100th Perpetual Preferred Series G (Marshall Islands)
NM$H	# Navios Maritime Holdings Inc. Sponsored ADR Representing 1/100th Perp. Preferred Series H%
NMA	# "Nuveen Municipal Advantage Fund
NMBL	# "Nimble Storage
NMFC	# New Mountain Finance Corporation Common Stock
NMI	# "Nuveen Municipal Income Fund
NMK$B	# "Niagara Mohawk Holdings
NMK$C	# "Niagara Mohawk Holdings
NMM	# Navios Maritime Partners LP Common Units Representing Limited Partner Interests
NMO	# "Nuveen Municipal Market Opportunity Fund
NMR	# Nomura Holdings Inc ADR American Depositary Shares
NMS	# Nuveen Minnesota Municipal Income Fund Common Shares of Beneficial Interest
NMT	# Nuveen Massachusetts Premium Income Municipal Fund Common Stock
NMY	# Nuveen Maryland Premium Income Municipal Fund Common Stock
NNA	# Navios Maritime Acquisition Corporation Common stock
NNC	# Nuveen North Carolina Premium Income Municipal Fund Common Stock
NNI	# "Nelnet
NNN	# National Retail Properties Common Stock
NNN$D	# National Retail Properties Depositary Shares Representing 1/100th Preferred Series D
NNN$E	# "National Retail Properties Depositary Shares
NNP	# "Nuveen New York Performance Plus Municipal Fund
NNY	# "Nuveen New York Municipal Value Fund
NOA	# "North American Energy Partners
NOAH	# Noah Holdings Limited
NOC	# Northrop Grumman Corporation Common Stock
NOK	# Nokia Corporation Sponsored American Depositary Shares
NOM$C	# Nuveen Missouri Premium Income Municipal Fund MUNIFUND TERM PFD SHS SER 2015 (United States)
NOR	# Noranda Aluminum Holding Corporation Common Stock
NORD	# "Nord Anglia Education
NOV	# "National Oilwell Varco
NOW	# "ServiceNow
NP	# "Neenah Paper
NPD	# China Nepstar Chain Drugstore Ltd American Depositary Shares
NPF	# "Nuveen Premier Municipal Income Fund
NPI	# "Nuveen Premium Income Municipal Fund
NPK	# "National Presto Industries
NPM	# "Nuveen Premium Income Municipal Fund II
NPO	# Enpro Industries Inc
NPP	# "Nuveen Performance Plus Municipal Fund
NPT	# "Nuveen Premium Income Municipal Fund IV
NPTN	# NeoPhotonics Corporation Common Stock
NPV	# Nuveen Virginia Premium Income Municipal Fund Common Stock
NQ	# "NQ Mobile Inc. American Depositary Shares
NQI	# "Nuveen Quality Municipal Fund
NQM	# "Nuveen Investment Quality Municipal Fund
NQP	# "Nuveen Pennsylvania Investment Quality Municipal Fund
NQS	# "Nuveen Select Quality Municipal Fund
NQU	# "Nuveen Quality Income Municipal Fund
NR	# "Newpark Resources
NRF	# NorthStar Realty Finance Corp. Common Stock (New)
NRF$A	# Northstar Realty Finance Corp. 8.75% Series A Cumulative Redeemable Preferred Stock
NRF$B	# Northstar Realty Finance Corp. Preferred Series B
NRF$C	# Northstar Realty Finance Corp. Preferred Series C
NRF$D	# Northstar Realty Finance Corp. 8.50% Series D Cumulative Redeemable Preferred Stock
NRF$E	# Northstar Realty Finance Corp. Preferred Stock Series E
NRG	# "NRG Energy
NRK	# Nuveen New York AMT
NRP	# Natural Resource Partners LP Limited Partnership
NRT	# North European Oil Royality Trust Common Stock
NRZ	# New Residential Investment Corp. Common Stock
NS	# Nustar Energy L.P.  Common Units
NSAM	# "NorthStar Asset Management Group
NSC	# Norfolk Southern Corporation Common Stock
NSH	# "Nustar GP Holdings
NSL	# Nuveen Senior Income Fund Common Stock
NSLP	# New Source Energy Partners L.P. Common Units Representing Limited Partner Interests
NSM	# Nationstar Mortgage Holdings Inc. Common Stock
NSP	# "Insperity
NSR	# "Neustar
NSS	# "NuStar Logistics
NTC	# Nuveen Connecticut Premium Income Municipal Fund Common Stock
NTG	# "Tortoise MLP Fund
NTI	# Northern Tier Energy LP Common Units representing Limited Partner Interests
NTL	# "Nortel Inversora SA
NTP	# Nam Tai Property Inc. Common Stock
NTT	# Nippon Telegraph and Telephone Corporation Common Stock
NTX	# Nuveen Texas Quality Income Municipal Fund Common Stock
NTX$C	# Nuveen Texas Quality Income Municipal Fund Munifund Term Pfd Shs Ser 2013
NTZ	# "Natuzzi
NU	# Northeast Utilities Common Stock
NUE	# Nucor Corporation Common Stock
NUM	# Nuveen Michigan Quality Income Municipal Fund Common Stock
NUO	# Nuveen Ohio Quality Income Municipal Fund Common Stock
NUS	# "Nu Skin Enterprises
NUV	# "Nuveen Municipal Value Fund
NUW	# Nuveen AMT
NVGS	# Navigator Holdings Ltd. Ordinary Shares (Marshall Islands)
NVO	# Novo Nordisk A/S Common Stock
NVR	# "NVR
NVRO	# Nevro Corp. Common Stock
NVS	# Novartis AG Common Stock
NW$C	# Natl Westminster Pfd Preferred Stock
NWE	# NorthWestern Corporation Common Stock
NWHM	# New Home Company Inc. (The) Common Stock
NWL	# Newell Rubbermaid Inc. Common Stock
NWN	# Northwest Natural Gas Company Common Stock
NWY	# "New York & Company
NX	# Quanex Building Products Corporation Common Stock
NXC	# Nuveen California Select Tax
NXJ	# Nuveen New Jersey Dividend Advantage Municipal Fund Share of Beneficial Interest
NXJ$C	# "Nuveen New Jersey Dividend Advantage Municipal Fund MuniFund Term Preferred Shares
NXN	# Nuveen New York Select Tax
NXP	# Nuveen Select Tax Free Income Portfolio Common Stock
NXQ	# Nuveen Select Tax Free Income Portfolio II Common Stock
NXR	# Nuveen Select Tax Free Income Portfolio III Common Stock
NYCB	# "New York Community Bancorp
NYCB$U	# "New York Community Bancorp
NYLD	# "NRG Yield
NYRT	# "New York REIT
NYT	# New York Times Company (The) Common Stock
O	# Realty Income Corporation Common Stock
O$F	# Realty Income Corporation Monthly Income Cumulative Red Preferred Stock Class F
OAK	# "Oaktree Capital Group
OAKS	# Five Oaks Investment Corp. Common Stock
OAKS$A	# Five Oaks Investment Corp. 8.75% Series A Cumulative Redeemable Preferred Stock
OAS	# Oasis Petroleum Inc. Common Stock
OB	# "OneBeacon Insurance Group
OC	# Owens Corning Inc Common Stock New
OCIP	# OCI Partners LP Common Units representing Limited Partner Interests
OCIR	# OCI Resources LP Common Units representing Limited Partner Interests
OCN	# Ocwen Financial Corporation NEW Common Stock
OCR	# "Omnicare
OCR$A	# "Omnicare
OCR$B	# "Omnicare
ODC	# Oil
OEC	# Orion Engineered Carbons S.A Common Shares
OFC	# Corporate Office Properties Trust Common Stock
OFC$L	# Corporate Office Properties Trust Preferred Series L
OFG	# OFG Bancorp Common Stock
OFG$A	# OFG Bancorp Preferred Stock
OFG$B	# OFG Bancorp 7.0% Non Cumulative Monthly Income Preferred Stock Series B
OFG$D	# OFG Bancorp 7.125% Non
OGE	# OGE Energy Corporation Common Stock
OGS	# "ONE Gas
OHI	# "Omega Healthcare Investors
OI	# Owens
OIA	# Invesco Municipal Income Opportunities Trust Common Stock
OIBR	# Oi S.A. American Depositary Shares (Each representing 1 Preferred Share)
OIBR.C	# "Oi S.A. American Depositary Shares
OII	# "Oceaneering International
OILT	# "Oiltanking Partners
OIS	# "Oil States International
OKE	# "ONEOK
OKS	# "ONEOK Partners
OLN	# Olin Corporation Common Stock
OLP	# "One Liberty Properties
OMAM	# OM Asset Management plc Ordinary Shares
OMC	# Omnicom Group Inc. Common Stock
OME	# Omega Protein Corporation Common Stock
OMG	# "OM Group
OMI	# "Owens & Minor
OMN	# OMNOVA Solutions Inc. Common Stock
ONDK	# "On Deck Capital
ONE	# "Higher One Holdings
OPK	# OPKO Health Inc. Common Stock
OPWR	# "Opower
OPY	# "Oppenheimer Holdings
ORA	# "Ormat Technologies
ORAN	# Orange
ORB	# Orbital Sciences Corporation Common Stock
ORC	# "Orchid Island Capital
ORCL	# Oracle Corporation Common Stock
ORI	# Old Republic International Corporation Common Stock
ORN	# Orion Marine Group Inc Common
OSK	# Oshkosh Corporation (Holding Company)Common Stock
OUBS	# UBS AG Common Stock
OUT	# OUTFRONT Media Inc. Common Stock
OWW	# "Orbitz Worldwide
OXM	# "Oxford Industries
OXY	# Occidental Petroleum Corporation Common Stock
OZM	# Och
P	# "Pandora Media
PAA	# "Plains All American Pipeline
PAC	# "Grupo Aeroportuario Del Pacifico
PACD	# Pacific Drilling S.A. Common Shares
PAG	# "Penske Automotive Group
PAGP	# "Plains Group Holdings
PAH	# Platform Specialty Products Corporation Common Stock
PAI	# Western Asset Income Fund Common Stock
PAM	# Pampa Energia S.A. Pampa Energia S.A.
PANW	# "Palo Alto Networks
PAR	# PAR Technology Corporation Common Stock
PAY	# "Verifone Systems
PAYC	# "Paycom Software
PB	# "Prosperity Bancshares
PBA	# Pembina Pipeline Corp. Ordinary Shares (Canada)
PBF	# PBF Energy Inc. Class A Common Stock
PBFX	# PBF Logistics LP Common Units representing limited partner interests
PBH	# "Prestige Brand Holdings
PBI	# Pitney Bowes Inc. Common Stock
PBI$A	# Pitney Bowes Inc 5.25% Notes due 2022
PBI$B	# Pitney Bowes Inc 6.70% Notes Due 2043
PBR	# Petroleo Brasileiro S.A.
PBR.A	# Petroleo Brasileiro S.A.
PBT	# Permian Basin Royalty Trust Common Stock
PBY	# Pep Boys
PBYI	# Puma Biotechnology Inc Common Stock
PCF	# Putnam High Income Securities Fund Common Stock
PCG	# Pacific Gas & Electric Co. Common Stock
PCI	# PIMCO Dynamic Credit Income Fund Common Shares of Beneficial Interest
PCK	# Pimco California Municipal Income Fund II Common Shares of Beneficial Interest
PCL	# "Plum Creek Timber Company
PCM	# "PCM Fund
PCN	# Pimco Corporate & Income Strategy Fund Common Stock
PCP	# Precision Castparts Corporation Common Stock
PCQ	# PIMCO California Municipal Income Fund Common Stock
PDI	# PIMCO Dynamic Income Fund Common Stock
PDM	# "Piedmont Office Realty Trust
PDS	# Precision Drilling Corporation Common Stock
PDT	# John Hancock Premium Dividend Fund
PE	# "Parsley Energy
PEB	# Pebblebrook Hotel Trust Common Shares of Beneficial Interest
PEB$A	# Pebblebrook Hotel Trust PFD SER A
PEB$B	# Pebblebrook Hotel Trust Preferred Series B
PEB$C	# Pebblebrook Hotel Trust 6.50% Series C Cumulative Redeemable Preferred Shares of Beneficial Interest
PEG	# Public Service Enterprise Group Incorporated Common Stock
PEI	# Pennsylvania Real Estate Investment Trust Common Stock
PEI$A	# Pennsylvania Real Estate Investment Trust PFD sh CL A
PEI$B	# Pennsylvania Real Estate Investment Trust Cumulative Redeemable Perpetual Preferred Shares Series B
PEO	# Petroleum Resources Corporation Common Stock
PEP	# "Pepsico
PER	# SandRidge Permian Trust Common Units of Benficial Interest
PES	# Pioneer Energy Services Corp. Common Stk
PF	# "Pinnacle Foods
PFD	# Flaherty & Crumrine Preferred Income Fund Incorporated Common Stock
PFE	# "Pfizer
PFG	# Principal Financial Group Inc Common Stock
PFG$B	# "Principal Financial Group
PFH	# Cabco Tr Jcp 7.625 Common Stock
PFK	# Prudential Financial Inflation
PFL	# PIMCO Income Strategy Fund Shares of Beneficial Interest
PFN	# PIMCO Income Strategy Fund II
PFO	# Flaherty & Crumrine Preferred Income Opportunity Fund Incorporated Common Stock
PFS	# "Provident Financial Services
PFSI	# "PennyMac Financial Services
PFX	# "Phoenix Companies
PG	# Procter & Gamble Company (The) Common Stock
PGEM	# "Ply Gem Holdings
PGH	# Pengrowth Energy Corporation
PGI	# "Premiere Global Services
PGN	# Paragon Offshore plc Ordinary Shares
PGP	# Pimco Global Stocksplus & Income Fund Pimco Global StocksPlus & Income Fund Common Shares of Beneficial Interest
PGR	# Progressive Corporation (The) Common Stock
PGRE	# "Paramount Group
PGZ	# Principal Real Estate Income Fund Common Shares of Beneficial Interest
PH	# Parker
PHD	# Pioneer Floating Rate Trust Pioneer Floating Rate Trust Shares of Beneficial Interest
PHG	# Koninklijke Philips N.V. NY Registry Shares
PHH	# PHH Corp Common Stock
PHI	# Philippine Long Distance Telephone Company Sponsored ADR
PHK	# Pimco High Income Fund Pimco High Income Fund
PHM	# "PulteGroup
PHT	# Pioneer High Income Trust Common Shares of Beneficial Interest
PHX	# Panhandle Oil and Gas Inc Common Stock
PII	# Polaris Industries Inc. Common Stock
PIM	# Putnam Master Intermediate Income Trust Common Stock
PIR	# "Pier 1 Imports
PIY	# Preferred Plus Trust (Ser CZN) Preferred Plus Trust Ser CZN
PJC	# Piper Jaffray Companies Common Stock
PJH	# "Prudential Financial
PJS	# PreferredPlus Trust Ser FAR 1 Tr Ctf
PKD	# Parker Drilling Company Common Stock
PKE	# Park Electrochemical Corporation Common Stock
PKG	# Packaging Corporation of America Common Stock
PKI	# "PerkinElmer
PKO	# Pimco Income Opportunity Fund Common Shares of Beneficial Interest
PKX	# POSCO Common Stock
PKY	# "Parkway Properties
PL	# Protective Life Corporation Common Stock
PL$B	# Protective Life Corporation PLC Capital Trust V Trust Originated Preferred Securities (TOPRS)
PL$C	# Protective Life Corporation 6.25% Subordinated Debentures due 2042
PL$E	# Protective Life Corporation 6.00% Subordinated Debentures due 2042
PLD	# "ProLogis
PLL	# Pall Corporation Common Stock
PLOW	# "Douglas Dynamics
PLT	# "Plantronics
PM	# Philip Morris International Inc Common Stock
PMC	# Pharmerica Corporation Common Stock
PMF	# PIMCO Municipal Income Fund Common Stock
PML	# Pimco Municipal Income Fund II Common Shares of Beneficial Interest
PMM	# Putnam Managed Municipal Income Trust Common Stock
PMO	# Putnam Municipal Opportunities Trust Common Stock
PMT	# PennyMac Mortgage Investment Trust Common Shares of Beneficial Interest
PMX	# PIMCO Municipal Income Fund III Common Shares of Beneficial Interest
PNC	# "PNC Financial Services Group
PNC$P	# "PNC Financial Services Group
PNC$Q	# "PNC Financial Services Group
PNC.W	# "PNC Financial Services Group
PNF	# PIMCO New York Municipal Income Fund Common Stock
PNI	# Pimco New York Municipal Income Fund II Common Shares of Beneficial Interest
PNK	# "Pinnacle Entertainment
PNM	# "PNM Resources
PNR	# Pentair plc. Ordinary Share
PNTA	# PennantPark Investment Corporation 6.25% Senior Notes due 2025
PNW	# Pinnacle West Capital Corporation Common Stock
PNX	# "Phoenix Companies
PNY	# "Piedmont Natural Gas Company
POL	# PolyOne Corporation Common Stock
POM	# "PEPCO Holdings
POR	# Portland General Electric Co Common Stock
POST	# "Post Holdings
POT	# Potash Corporation of Saskatchewan Inc. Common Stock
POWR	# "PowerSecure International
PPG	# "PPG Industries
PPL	# PP&L Corporation Common Stock
PPO	# Polypore International Inc Common Stock
PPP	# Primero Mining Corp.  New Common Shares (Canada)
PPR	# Voya Prime Rate Trust Shares of Beneficial Interest
PPS	# "Post Properties
PPS$A	# "Post Properties
PPT	# Putnam Premier Income Trust Common Stock
PPX	# "PPL Capital Funding
PQ	# Petroquest Energy Inc Common Stock
PRA	# ProAssurance Corporation Common Stock
PRE	# PartnerRe Ltd. Common Stock
PRE$D	# PartnerRe Ltd. Preferred Series D 6.5% (Bermuda)
PRE$E	# PartnerRe Ltd. PFD SER E (Bermuda)
PRE$F	# PartnerRe Ltd. Redeemable Preferred Shares Series F (Bermuda)
PRGO	# Perrigo Company plc Ordinary Shares
PRH	# "Prudential Financial
PRI	# "Primerica
PRLB	# "Proto Labs
PRO	# "PROS Holdings
PRU	# "Prudential Financial
PRY	# Prospect Capital Corporation 6.95% Senior Notes due 2022
PSA	# Public Storage Common Stock
PSA$A	# "Public Storage Depositary Shares each representing 1/1
PSA$O	# Public Storage Depositary Shares Representing 1/1000% Cumulative Pfd Sh Ben Int Series O
PSA$P	# Public Storage DEPOSITARY SHS REPSTG % CUMULATIVE PFD SHS BEN INT (SER P)
PSA$Q	# Public Storage DEPOSITARY SHS REPSTG 1/1000TH PFD SHS BEN INT SER Q
PSA$R	# Public Storage Depository Sh Repstg 1/1000th Pfd Ser R
PSA$S	# Public Storage DEP SH REPSTG PFD SH BEN INT SER S
PSA$T	# Public Storage Depository Shares Representing 1/1000 Pfd Shares Beneficial Interest Series T
PSA$U	# Public Storage Depositary Shares Representing 1/1000 Preferred Benerficial Interest Series U
PSA$V	# Public Storage Dep Shs Repstg 1/1000th Pfd Sh Ben Int Ser V
PSA$W	# Public Storage Depositary Shares Representing 1/1000 Preferred Shares of Benficial Interest Series W
PSA$X	# Public Storage Depositary Shares Representing 1/1000th Cumulative Preferred Shares Beneficial Interest Series X
PSA$Y	# Public Storage Dep Shs Repstg 1/1000th Pfd Sh Ben Int Ser Y
PSA$Z	# Public Storage Dep Shs Representing 1/1000th Pfd Sh Ben Int Ser Z
PSB	# "PS Business Parks
PSB$R	# "PS Business Parks
PSB$S	# "PS Business Parks
PSB$T	# "PS Business Parks
PSB$U	# "PS Business Parks
PSB$V	# "PS Business Parks
PSF	# "Cohen & Steers Select Preferred and Income Fund
PSG	# Performance Sports Group Ltd. Ordinary Shares (Canada)
PSO	# "Pearson
PSX	# Phillips 66 Common Stock
PSXP	# Phillips 66 Partners LP Common Units representing limited partner interest in the Partnership
PT	# "Portugal Telecom SGPS
PTP	# "Platinum Underwriters Holdings
PTR	# PetroChina Company Limited Common Stock
PTY	# Pimco Corporate & Income Opportunity Fund
PUK	# Prudential Public Limited Company Common Stock
PUK$	# Prudential Public Limited Company 6.75% Perpetual Subordinated Captial Security
PUK$A	# Prudential Public Limited Company 6.50% Perpetual Subordinated Capital Securities Exchangeable at the Issuer's Option Into Non
PVA	# Penn Virginia Corporation Common Stock
PVG	# "Pretium Resources
PVH	# PVH Corp. Common Stock
PVTD	# "PrivateBancorp
PWE	# Penn West Petroleum Ltd
PWR	# "Quanta Services
PX	# "Praxair
PXD	# Pioneer Natural Resources Company Common Stock
PYB	# PPlus Trust Series GSG
PYN	# PIMCO New York Municipal Income Fund III Common Shares of Beneficial Interest
PYS	# Merrill Lynch Depositor Inc PPlus Tr Ser RRD
PYT	# PPlus Tr GSC
PZB	# "Merrill Lynch Depositor
PZC	# PIMCO California Municipal Income Fund III Common Shares of Beneficial Interest
PZE	# Petrobras Argentina S.A. ADS
PZN	# Pzena Investment Management Inc Class A Common Stock
Q	# Quintiles Transnational Holdings Inc. Common Stock
QEP	# "QEP Resources
QEPM	# "QEP Midstream Partners
QIHU	# "Qihoo 360 Technology Co. Ltd. American Depositary Shares
QSR	# Restaurant Brands International Inc. Common Shares
QTM	# Quantum Corporation Common Stock
QTS	# "QTS Realty Trust
QTWO	# "Q2 Holdings
QUAD	# "Quad Graphics
R	# "Ryder System
RAD	# Rite Aid Corporation Common Stock
RAI	# Reynolds American Inc Common Stock
RALY	# Rally Software Development Corp. Common Stock
RAS	# RAIT Financial Trust New Common Shares of Beneficial Interest
RAS$A	# RAIT Financial Trust  7.75% Series A Cumulative Redeemable Preferred Shares of Beneficial Interest
RAS$B	# RAIT Financial Trust 8.375% Series B Cumulative Redeemable Preferred Shares of Beneficial Interest
RAS$C	# RAIT Financial Trust 8.875% Series C Cumulative Redeemable Preferred Shares of Beneficial Interest
RATE	# "Bankrate
RAX	# "Rackspace Hosting
RBA	# Ritchie Bros. Auctioneers Incorporated Common Stock
RBC	# Regal Beloit Corporation Common Stock
RBS	# Royal Bank of Scotland Group Plc New (The) ADS
RBS$E	# RBS Capital Funding Trust V
RBS$F	# Royal Bank of Scotland Group Plc (The) Preferred Stock
RBS$G	# RBS Capital Funding Trust VII
RBS$H	# Royal Bank of Scotland Group Plc (The) Preferred Stock
RBS$I	# RBS Capital Funding Trust VI
RBS$L	# Royal Bank of Scotland Group Plc (The) ADR representing One Non
RBS$M	# Royal Bank of Scotland Group Plc (The) ADS Series M
RBS$N	# Royal Bank of Scotland Group Plc (The) Royal Bank of Scotland Group PLC (The) American Depositary Shares (each representing One Non
RBS$P	# Royal Bank of Scotland Group Plc (The) ADR representing Preferred Shares Series P
RBS$Q	# Royal Bank of Scotland Group Plc (The) ADR repstg Pref Shs Ser Q
RBS$R	# Royal Bank of Scotland Group Plc (The) ADR repstg USD Pfd Shs Ser R (United Kingdom)
RBS$S	# Royal Bank of Scotland Group Plc (The) Sponsored ADR Repstg Pref Ser S (United Kingdom)
RBS$T	# Royal Bank of Scotland Group Plc (The) Sponsored ADR Representing Pfef shs ser T (United Kingdom)
RCAP	# RCS CAPITAL CORPORATION Common Stock
RCI	# "Rogers Communication
RCL	# Royal Caribbean Cruises Ltd. Common Stock
RCS	# "PIMCO Strategic Income Fund
RDC	# Rowan Companies plc Class A Ordinary Shares
RDN	# Radian Group Inc. Common Stock
RDS.A	# Royal Dutch Shell PLC Royal Dutch Shell American Depositary Shares (Each representing two Class A Ordinary Shares)
RDS.B	# Royal Dutch Shell PLC Royal Dutch Shell PLC American Depositary Shares (Each representing two Class B Ordinary Shares)
RDY	# Dr. Reddy's Laboratories Ltd Common Stock
RE	# "Everest Re Group
REG	# Regency Centers Corporation Common Stock
REG$F	# Regency Centers Corporation Cumulative Red Preferred Series 6%
REG$G	# Regency Centers Corporation Pfd Ser 7%
REN	# Resolute Energy Corporation Comon Stock
RENN	# "Renren Inc. American Depositary Shares
RES	# "RPC
RESI	# Altisource Residential Corporation Common Stock
REV	# "Revlon
REX	# REX American Resources Corporation
REXR	# "Rexford Industrial Realty
RF	# Regions Financial Corporation Common Stock
RF$A	# Regions Financial Corporation Depositary Shares Representing 1/40th Perpetual Preferred Series A
RF$B	# Regions Financial Corporation Depositary Shares Representing 1/40th Perpetual Preferred Series B
RFI	# "Cohen & Steers Total Return Realty Fund
RFP	# Resolute Forest Products Inc. Common Stock
RFT	# RAIT Financial Trust 7.625% Senior Notes due 2024
RFTA	# RAIT Financial Trust 7.125% Senior Notes due 2019
RGA	# "Reinsurance Group of America
RGC	# Regal Entertainment Group Class A Common Stock
RGP	# Regency Energy Partners LP Common Units Representing Limited Partner Interests
RGR	# "Sturm
RGS	# Regis Corporation Common Stock
RGT	# "Royce Global Value Trust
RH	# Restoration Hardware Holdings Inc. Common Stock
RHI	# Robert Half International Inc. Common Stock
RHP	# "Ryman Hospitality Properties
RHT	# "Red Hat
RICE	# Rice Energy Inc. Common Stock
RIG	# Transocean Ltd (Switzerland) Common Stock
RIGP	# Transocean Partners LLC Common Units Representing Limited Liability Company Interests
RIO	# Rio Tinto Plc Common Stock
RIOM	# Rio Alto Mining Limited Common Shares (Canada)
RIT	# LMP Real Estate Income Fund Inc Common Stock
RJD	# "Raymond James Financial
RJF	# "Raymond James Financial
RKT	# Rock
RKUS	# "Ruckus Wireless
RL	# Ralph Lauren Corporation Common Stock
RLD	# RealD Inc Common Stock
RLGY	# Realogy Holdings Corp. Common Stock
RLH	# Red Lions Hotels Corporation Common Stock
RLH$A	# Red Lion Hotels Capital Trust Red Lion Hotels Capital Trust
RLI	# RLI Corp. Common Stock
RLJ	# RLJ Lodging Trust Common Shares of Beneficial Interest $0.01 par value
RM	# Regional Management Corp. Common Stock
RMAX	# "RE/MAX Holdings
RMD	# ResMed Inc. Common Stock
RMP	# Rice Midstream Partners LP Common Units representing limited partner interests
RMT	# Royce Micro
RNDY	# "Roundy's
RNE	# "Morgan Stanley Eastern Europe Fund
RNF	# "Rentech Nitrogen Partners
RNG	# "Ringcentral
RNO	# Rhino Resource Partners LP Common Units representing limited partnership interests
RNP	# Cohen & Steers Reit and Preferred Income Fund Inc Common Shares
RNR	# RenaissanceRe Holdings Ltd. Common Stock
RNR$C	# RenaissanceRe Holdings Ltd. 6.08% Series C Preference Shares
RNR$E	# RenaissanceRe Holdings Ltd. 5.375% Series E Preference Shares
ROC	# "Rockwood Holdings
ROG	# Rogers Corporation Common Stock
ROK	# "Rockwell Automation
ROL	# "Rollins
ROP	# "Roper Industries
ROYT	# Pacific Coast Oil Trust Units of Beneficial Interest
RPAI	# "Retail Properties of America
RPAI$A	# "Retail Properties of America
RPM	# RPM International Inc. Common Stock
RPT	# Ramco
RPT$D	# Ramco
RQI	# Cohen & Steers Quality Income Realty Fund Inc Common Shares
RRC	# Range Resources Corporation Common Stock
RRMS	# "Rose Rock Midstream
RRTS	# "Roadrunner Transportation Systems
RS	# Reliance Steel & Aluminum Co. Common Stock
RSE	# "Rouse Properties
RSG	# "Republic Services
RSH	# Radioshack Corporation Common Stock
RSO	# Resource Capital Corp. Resource Capital Corp. Common Stock
RSO$A	# Resource Capital Corp. 8.50% Series A Cumulative Redeemable Preferred Stock
RSO$B	# Resource Capital Corp. Pfd Ser B
RSO$C	# Resource Capital Corp. Preferred Series C
RSPP	# "RSP Permian
RST	# "Rosetta Stone Rosetta Stone
RT	# "Ruby Tuesday
RTEC	# "Rudolph Technologies
RTI	# "RTI International Metals
RTN	# Raytheon Company Common Stock
RUBI	# "The Rubicon Project
RUK	# Reed Elsevier NV PLC New ADS
RVT	# "Royce Value Trust
RWT	# "Redwood Trust
RXN	# Rexnord Corporation Common Stock
RY	# Royal Bank Of Canada Common Stock
RYAM	# Rayonier Advanced Materials Inc. Common Stock
RYI	# Ryerson Holding Corporation Common Stock
RYL	# "Ryland Group
RYN	# Rayonier Inc. REIT Common Stock
RZA	# "Reinsurance Group of America
S	# Sprint Corporation Common Stock
SA	# "Seabridge Gold
SAH	# "Sonic Automotive
SAIC	# SCIENCE APPLICATIONS INTERNATIONAL CORPORATION Common Stock
SALT	# Scorpio Bulkers Inc. Common Stock
SAM	# "Boston Beer Company
SAN	# "Banco Santander
SAN$A	# "Banco Santander
SAN$B	# Santander Finance Preferred SA Unipersonal Floating Rate Non
SAN$C	# "Banco Santander
SAN$I	# "Banco Santander Central Hispano
SAP	# SAP  SE ADS
SAQ	# Saratoga Investment Corp 7.50% Notes due 2020
SAR	# Saratoga Investment Corp New
SB	# "Safe Bulkers
SB$B	# "Safe Bulkers
SB$C	# "Safe Bulkers
SB$D	# "Safe Bulkers
SBGL	# Sibanye Gold Limited American Depositary Shares (Each representing four ordinary shares)
SBH	# "Sally Beauty Holdings
SBNA	# Scorpio Tankers Inc. 6.75% Senior Notes due 2020
SBNB	# Scorpio Tankers Inc. 7.50% Senior Notes Due 2017
SBR	# Sabine Royalty Trust Common Stock
SBS	# Companhia de saneamento Basico Do Estado De Sao Paulo
SBW	# Western Asset Worldwide Income Fund Inc. Common Stock
SBY	# Silver Bay Realty Trust Corp. Common Stock
SC	# Santander Consumer USA Holdings Inc. Common Stock
SCCO	# Southern Copper Corporation Common Stock
SCD	# LMP Capital and Income Fund Inc. Common Stock
SCE$F	# Southern California Edison Trust I Trust Preferred Securities
SCE$G	# SCE Trust II Trust Preferred Securities
SCE$H	# SCE Trust III Fixed/Floating Rate Trust Preference Securities
SCG	# SCANA Corporation Common Stock
SCHW	# Charles Schwab Corporation (The) Common Stock
SCHW$B	# Charles Schwab Corporation Depositary Shares Representing 1/40th Int Sh Non Cumulative Preferred Stock Series B
SCI	# Service Corporation International Common Stock
SCL	# Stepan Company Common Stock
SCM	# Stellus Capital Investment Corporation Common Stock
SCQ	# Stellus Capital Investment Corporation 6.50% Notes due 2019
SCS	# Steelcase Inc. Common Stock
SCU	# Scana Corporation SCANA CORPORATION 2009 Series A 7.70% Enhanced Junior Subordinated Notes
SCX	# L.S. Starrett Company (The) Common Stock
SD	# Sandridge Energy Inc. Common Stock
SDLP	# Seadrill Partners LLC Common Units Representing Limited Liability Company Interests
SDR	# SandRidge Mississippian Trust II Common Units representing Beneficial Interests
SDRL	# Seadrill Limited Ordinary Shares (Bermuda)
SDT	# SandRidge Mississippian Trust I Common Units of Beneficial Interest
SE	# Spectra Energy Corp Common Stock
SEAS	# "SeaWorld Entertainment
SEE	# Sealed Air Corporation Common Stock
SEM	# Select Medical Holdings Corporation Common Stock
SEMG	# Semgroup Corporation Class A Common Stock
SEP	# "Spectra Energy Partners
SERV	# "ServiceMaster Global Holdings
SF	# Stifel Financial Corporation Common Stock
SFB	# Stifel Financial Corp. 6.70% Senior Note due 2022
SFE	# "Safeguard Scientifics
SFG	# "StanCorp Financial Group
SFL	# Ship Finance International Limited
SFN	# Stifel Financial Corporation 5.375% Senior Notes due December 2022
SFS	# "Smart & Final Stores
SFUN	# "SouFun Holdings Limited American Depositary Shares (Each representing Four Class A Ordinary Shares
SFY	# Swift Energy Company (Holding Company) Common Stock
SGF	# "Aberdeen Singapore Fund
SGL	# "Strategic Global Income Fund
SGM	# Stonegate Mortgage Corporation Common Stock
SGU	# "Star Gas Partners
SGY	# Stone Energy Corporation Common Stock
SGZA	# "Selective Insurance Group
SHG	# Shinhan Financial Group Co Ltd American Depositary Shares
SHI	# "SINOPEC Shangai Petrochemical Company
SHLX	# "Shell Midstream Partners
SHO	# "Sunstone Hotel Investors
SHO$D	# "Sunstone Hotel Investors
SHW	# Sherwin
SID	# Companhia Siderurgica Nacional S.A. Common Stock
SIG	# Signet Jewelers Limited Common Shares
SIR	# Select Income REIT Common Shares of Beneficial Interest
SIX	# Six Flags Entertainment Corporation New Common Stock
SJI	# "South Jersey Industries
SJM	# J.M. Smucker Company (The) New Common Stock
SJR	# Shaw Communications Inc. Common Stock
SJT	# San Juan Basin Royalty Trust Common Stock
SJW	# SJW Corporation Common Stock
SKH	# "Skilled Healthcare Group
SKM	# "SK Telecom Co.
SKT	# "Tanger Factory Outlet Centers
SKX	# "Skechers U.S.A.
SLB	# Schlumberger N.V. Common Stock
SLCA	# "U.S. Silica Holdings
SLF	# Sun Life Financial Inc. Common Stock
SLG	# SL Green Realty Corporation Common Stock
SLG$I	# SL Green Realty Corporation Preferred Series I
SLH	# "Solera Holdings
SLRA	# Solar Capital Ltd. 6.75% Senior Notes due 2042
SLTB	# Scorpio Bulkers Inc. 7.50% Senior Notes due 2019
SLW	# Silver Wheaton Corp Common Shares (Canada)
SM	# SM Energy Company Common Stock
SMFG	# Sumitomo Mitsui Financial Group Inc Unsponsored American Depositary Shares (Japan)
SMG	# Scotts Miracle
SMI	# Semiconductor  Manufacturing International Corporation ADR
SMLP	# "Summit Midstream Partners
SMM	# Salient Midstream Common Shares of Beneficial Interest
SMP	# "Standard Motor Products
SN	# Sanchez Energy Corporation Common Stock
SNA	# Snap
SNE	# Sony Corporation Common Stock
SNH	# Senior Housing Properties Trust Common Stock
SNHN	# Senior Housing Properties Trust 5.625% Senior Notes due 2042
SNI	# "Scripps Networks Interactive
SNN	# "Smith & Nephew SNATS
SNOW	# "Intrawest Resorts Holdings
SNP	# China Petroleum & Chemical Corporation Common Stock
SNR	# New Senior Investment Group Inc. Common Stock
SNV	# Synovus Financial Corp. Common Stock
SNV$C	# Synovus Financial Corp. Perp Pfd Ser C Fxd To Fltg
SNX	# Synnex Corporation Common Stock
SNY	# Sanofi American Depositary Shares (Each repstg one
SO	# Southern Company (The) Common Stock
SOL	# Renesola Ltd. Common Shares of Beneficial Interest
SON	# Sonoco Products Company Common Stock
SOR	# "Source Capital
SOV$C	# "Santander Holdings USA
SPA	# Sparton Corporation Common Stock
SPB	# "Spectrum Brands Holdings
SPE	# "Special Opportunities Fund
SPF	# Standard Pacific Corp Common Stock
SPG	# "Simon Property Group
SPG$J	# "Simon Property Group
SPH	# "Suburban Propane Partners
SPLP	# Steel Partners Holdings LP LTD PARTNERSHIP UNIT
SPN	# "Superior Energy Services
SPR	# "Spirit Aerosystems Holdings
SPW	# SPX Corporation Common Stock
SPXX	# Nuveen S&P 500 Dynamic Overwrite Fund
SQM	# Sociedad Quimica y Minera S.A. Common Stock
SQNS	# "Sequans Communications S.A. American Depositary Shares
SR	# Standard Register Company (The) Common Stock
SRC	# "Spirit Realty Capital
SRE	# Sempra Energy Common Stock
SRF	# The Cushing Royalty & Income Fund Common Shares of Beneficial Interest
SRI	# "Stoneridge
SRLP	# Sprague Resources LP Common Units representing Limited Partner Interests
SRT	# "StarTek
SRV	# The Cushing MLP Total Return Fund Common Shares of Beneficial Interest
SSD	# "Simpson Manufacturing Company
SSE	# Seventy Seven Energy Inc. Common Stock
SSI	# "Stage Stores
SSL	# Sasol Ltd. American Depositary Shares
SSLT	# Sesa Sterlite Limited  American Depositary Shares (Each representing four equity shares)
SSNI	# "Silver Spring Networks
SSP	# E.W. Scripps Company (The) Common Stock
SSS	# "Sovran Self Storage
SSTK	# "Shutterstock
SSW	# Seaspan Corporation Seaspan Corporation Common Shares
SSW$C	# Seaspan Corporation 9.50% Series C Cumulative Redeemable Perpetual Preferred Shares
SSW$D	# Seaspan Corporation Cumulative Redeemable Perpetual Preferred Series D (Marshall Islands)
SSW$E	# Seaspan Corporation Cumulative Redeemable Perpetual Preferred Series E (Marshall Islands)
SSWN	# Seaspan Corporation 6.375% Notes due 2019
ST	# Sensata Technologies Holding N.V. Ordinary Shares
STAG	# "Stag Industrial
STAG$A	# "Stag Industrial
STAG$B	# "Stag Industrial
STAR	# iStar Financial Inc. Common Stock
STAR$D	# iStar Financial Inc. Preferred Stock
STAR$E	# iStar Financial Inc. 7.875% Preferred Ser E
STAR$F	# iStar Financial Inc. Series F Preferred Stock
STAR$G	# iStar Financial Inc. Preferred Stock Series G
STAR$I	# iStar Financial Inc. Preferred Series I
STAY	# "Extended Stay America
STC	# Stewart Information Services Corporation Common Stock
STE	# STERIS Corporation Common Stock
STI	# "SunTrust Banks
STI$A	# "SunTrust Banks
STI$E	# "SunTrust Banks
STI.A	# "SunTrust Banks
STI.B	# "SunTrust Banks
STJ	# "St. Jude Medical
STK	# Columbia Seligman Premium Technology Growth Fund Inc
STL	# Sterling Bancorp
STM	# STMicroelectronics N.V. Common Stock
STN	# Stantec Inc Common Stock
STNG	# Scorpio Tankers Inc. Common Shares
STO	# Statoil ASA
STON	# StoneMor Partners L.P. Common Unit Rep Limited Partnership Interests
STOR	# STORE Capital Corporation Common Stock
STR	# Questar Corporation Common Stock
STRI	# "STR Holdings
STT	# State Street Corporation Common Stock
STT$C	# State Street Corporation Dep Shs Representing 1/4000 Ownership Int In Sh Non Cum (Perpertual Pfd Stk Ser C)
STT$D	# State Street Corporation Depositary Shares representing 1/4000th Perpetual Preferred Series D
STT$E	# "State Street Corporation Depository Shares
STV	# "China Digital TV Holding Co.
STWD	# "STARWOOD PROPERTY TRUST
STZ	# "Constellation Brands
STZ.B	# "Constellation Brands
SU	# Suncor Energy  Inc. Common Stock
SUI	# "Sun Communities
SUI$A	# "Sun Communities
SUN	# Sunoco LP Common Units representing limited partner interests
SUNE	# "SunEdison
SUP	# "Superior Industries International
SVM	# Silvercorp Metals Inc Ordinary Shares (Canada)
SVU	# SuperValu Inc. Common Stock
SWAY	# Starwood Waypoint Residential Trust Common Stock
SWC	# Stillwater Mining Company Common Stock ($0.01 Par Value)
SWFT	# Swift Transportation Company Class A Common Stock
SWH	# "Stanley Black & Decker
SWI	# "Solarwinds
SWJ	# "Stanley Black & Decker
SWK	# "Stanley Black & Decker
SWM	# Schweitzer
SWN	# Southwestern Energy Company Common Stock
SWU	# "Stanley Black & Decker
SWX	# Southwest Gas Corporation Common Stock
SWY	# Safeway Inc. Common Stock
SWZ	# "Swiss Helvetia Fund
SXC	# "SunCoke Energy
SXCP	# "SunCoke Energy Partners
SXE	# "Southcross Energy Partners
SXI	# Standex International Corporation Common Stock
SXL	# Sunoco Logistics Partners LP Common Units representing limited partner interests
SXT	# Sensient Technologies Corporation Common Stock
SYA	# Symetra Financial Corporation Common Stock $0.01 par value
SYF	# Synchrony Financial Common Stock
SYK	# Stryker Corporation Common Stock
SYT	# Syngenta AG Common Stock
SYX	# Systemax Inc. Common Stock
SYY	# Sysco Corporation Common Stock
SZC	# Cushing Renaissance Fund (The) Common Shares of Beneficial Interest
T	# AT&T Inc.
TA	# TravelCenters of America LLC Common Stock
TAC	# TransAlta Corporation Ordinary Shares
TAHO	# "Tahoe Resources
TAI	# "Transamerica Income Shares
TAL	# "TAL International Group
TANN	# TravelCenters of America LLC 8.25% Senior Notes due 2028
TANO	# TravelCenters of America LLC 8.00% Senior Notes due 2029
TAOM	# Taomee Holdings Limited American Depositary Shares (each representing 20 ordinary shares)
TAP	# Molson Coors Brewing Company Class B Common Stock
TAP.A	# Molson Coors Brewing  Company Molson Coors Brewing Company Class A Common Stock
TARO	# Taro Pharmaceutical Industries Ltd. Ordinary Shares
TBI	# "TrueBlue
TC	# Thompson Creek Metals Company Inc. Ordinary Shares (Canada)
TCAP	# Triangle Capital Corporation Common Stock
TCB	# TCF Financial Corporation Common Stock
TCB$B	# TCF Financial Corporation Del Dep Shs Repstg 1/1000 Pfd Ser A
TCB$C	# TCF Financial Corporation Perp Pfd Ser B
TCB.W	# TCF Financial Corporation TCF Financial Corporation Warrants
TCC	# Triangle Capital Corporation 7.00% Senior Notes due 2019
TCCA	# Triangle Capital Corporation 6.375% Senior Notes due 2022
TCI	# "Transcontinental Realty Investors
TCK	# Teck Resources Ltd Ordinary Shares
TCO	# "Taubman Centers
TCO$J	# "Taubman Centers
TCO$K	# "Taubman Centers
TCP	# "TC PipeLines
TCPI	# TCP International Holdings Ltd. Common Shares
TCRX	# "THL Credit
TCS	# Container Store (The) Common Stock
TD	# Toronto Dominion Bank (The) Common Stock
TDA	# "Telephone and Data Systems
TDC	# Teradata Corporation Common Stock
TDE	# "Telephone and Data Systems
TDF	# "Templeton Dragon Fund
TDG	# Transdigm Group Incorporated Transdigm Group Inc. Common Stock
TDI	# "Telephone and Data Systems
TDJ	# "Telephone and Data Systems
TDS	# "Telephone and Data Systems
TDW	# Tidewater Inc. Common Stock
TDY	# Teledyne Technologies Incorporated Common Stock
TE	# "TECO Energy
TEF	# Telefonica SA Common Stock
TEG	# "Integrys Energy Group
TEI	# "Templeton Emerging Markets Income Fund
TEL	# TE Connectivity Ltd. New Switzerland Registered Shares
TEN	# Tenneco Inc. Common Stock
TEO	# Telecom Argentina SA
TEP	# "Tallgrass Energy Partners
TER	# "Teradyne
TEU	# Box Ships Inc. Common Shares
TEU$C	# Box Ships Inc. 9.00% Series C Cumulative Perpetual Preferred Stock
TEVA	# Teva Pharmaceutical Industries Limited American Depositary Shares
TEX	# Terex Corporation Common Stock
TFG	# "Fixed Income Trust for Goldman Sachs Subordinated Notes
TFX	# Teleflex Incorporated Common Stock
TG	# Tredegar Corporation Common Stock
TGH	# Textainer Group Holdings Limited Common Shares
TGI	# "Triumph Group
TGP	# Teekay LNG Partners L.P.
TGS	# Transportadora de Gas del Sur SA TGS Common Stock
TGT	# Target Corporation Common Stock
THC	# Tenet Healthcare Corporation Common Stock
THG	# Hanover Insurance Group Inc
THGA	# "The Hanover Insurance Group
THO	# "Thor Industries
THQ	# Tekla Healthcare Opportunies Fund Shares of Beneficial Interest
THR	# "Thermon Group Holdings
THS	# "Treehouse Foods
TI	# Telecom Italia S.P.A. New
TI.A	# Telecom Italia S.P.A. New
TIF	# Tiffany & Co. Common Stock
TIME	# Time Inc. Common Stock
TISI	# "Team
TJX	# "TJX Companies
TK	# Teekay Corporation Common Stock
TKC	# Turkcell Iletisim Hizmetleri AS Common Stock
TKF	# "Turkish Investment Fund
TKR	# Timken Company (The) Common Stock
TLI	# LMP Corporate Loan Fund Inc Common Stock
TLK	# "PT Telekomunikasi Indonesia
TLLP	# Tesoro Logistics LP Common Units representing Limited Partner Interests
TLM	# Talisman Energy Inc. Common Stock
TLP	# Transmontaigne Partners L.P. Transmontaigne Partners L.P. Common Units representing limited partner interests
TLYS	# "Tilly's
TM	# Toyota Motor Corporation Common Stock
TMH	# "Team Health Holdings
TMHC	# Taylor Morrison Home Corporation Class A Common Stock
TMK	# Torchmark Corporation Common Stock
TMK$B	# Torchmark Corporation 5.875% Junior Subordinated Debenture due 2052
TMO	# Thermo Fisher Scientific Inc Common Stock
TMST	# Timken Steel Corporation Common Shares
TMUS	# T
TMUS$A	# T
TNC	# Tennant Company Common Stock
TNET	# "TriNet Group
TNH	# "Terra Nitrogen Company
TNK	# Teekay Tankers Ltd.
TNP	# Tsakos Energy Navigation Ltd Common Shares
TNP$B	# Tsakos Energy Navigation Ltd Red Perp Pfd Ser B% (Bermuda)
TNP$C	# Tsakos Energy Navigation Ltd 8.875% Series C Preferred Cumulative Redeemable Perpetual Preferred Shares
TOL	# Toll Brothers Inc. Common Stock
TOO	# Teekay Offshore Partners L.P. Common Units representing Limited Partner Interests
TOO$A	# Teekay Offshore Partners L.P. 7.25% Series A Redeemable Preferred Units
TOT	# Total S.A.
TOWR	# "Tower International
TPC	# Tutor Perini Corporation Common Stock
TPH	# "Tri Pointe Homes
TPL	# Texas Pacific Land Trust Common Stock
TPRE	# Third Point Reinsurance Ltd. Common Shares
TPUB	# Tribune Publishing Company Common Stock
TPVG	# TriplePoint Venture Growth BDC Corp. Common Stock
TPX	# "Tempur Sealy International
TPZ	# "Tortoise Power and Energy Infrastructure Fund
TR	# "Tootsie Roll Industries
TRC	# Tejon Ranch Co Common Stock
TRCO	# Tribune Media Company Class A Common Stock
TREC	# Trecora Resources Common Stock
TREX	# "Trex Company
TRF	# "Templeton Russia and East European Fund
TRGP	# "Targa Resources
TRI	# Thomson Reuters Corp Ordinary Shares
TRK	# "Speedway Motorsports
TRLA	# "Trulia
TRMR	# "Tremor Video
TRN	# "Trinity Industries
TRNO	# Terreno Realty Corporation Common Stock
TRNO$A	# Terreno Realty Corporation Preferred Shares Series A
TROX	# Tronox Limited Ordinary Shares Class A $0.01 par
TRP	# TransCanada Corporation Common Stock
TRQ	# Turquoise Hill Resources Ltd. Ordinary Shares
TRR	# "TRC Companies
TRUP	# "Trupanion
TRV	# "The Travelers Companies
TRW	# TRW Automotive Holdings Corporation Common Stock
TS	# Tenaris S.A. American Depositary Shares
TSE	# Trinseo S.A. Ordinary Shares
TSI	# "TCW Strategic Income Fund
TSL	# Trina Solar Limited Sponsored ADR (Cayman Islands)
TSLF	# THL Credit Senior Loan Fund Common Shares of Beneficial Interest
TSLX	# "TPG Specialty Lending
TSM	# Taiwan Semiconductor Manufacturing Company Ltd.
TSN	# "Tyson Foods
TSNU	# "Tyson Foods
TSO	# Tesoro Corporation Common Stock
TSQ	# "Townsquare Media
TSS	# "Total System Services
TSU	# TIM Participacoes S.A. American Depositary Shares (Each representing 5 Common Shares)
TTC	# Toro Company (The) Common Stock
TTF	# "Thai Fund
TTI	# "Tetra Technologies
TTM	# Tata Motors Ltd Tata Motors Limited
TTP	# "Tortoise Pipeline & Energy Fund
TU	# Telus Corporation Ordinary Shares
TUMI	# "Tumi Holdings
TUP	# Tupperware Brands Corporation Common Stock
TV	# Grupo Televisa S.A. Common Stock
TVC	# Tennessee Valley Authority Common Stock
TVE	# Tennessee Valley Authority
TVPT	# Travelport Worldwide Limited Common Shares
TW	# Towers Watson & Co Common Stock Class A
TWC	# Time Warner Cable Inc Common Stock
TWI	# "Titan International
TWN	# "Taiwan Fund
TWO	# Two Harbors Investment Corp
TWTR	# "Twitter
TWX	# Time Warner Inc. New Common Stock
TX	# "Ternium S.A. Ternium S.A. American Depositary Shares (each representing ten shares
TXT	# Textron Inc. Common Stock
TXTR	# Textura Corporation Common Stock
TY	# Tri Continental Corporation Common Stock
TY$	# Tri Continental Corporation Preferred Stock
TYC	# Tyco International plc (Ireland) Ordinary Share
TYG	# Tortoise Energy Infrastructure Corporation Common Stock
TYG$B	# Tortoise Energy Infrastructure Corporation Mandatory Red Pfd Ser B
TYG$C	# Tortoise Energy Infrastructure Corporation Series C Mandatory Redeemable Preferred Shares
TYL	# "Tyler Technologies
TZF	# "Bear Stearns Depositor
UA	# "Under Armour
UAL	# United Continental Holdings
UAM	# Universal American Corporation New Common Stock
UAN	# "CVR Partners
UBA	# Urstadt Biddle Properties Inc. Common Stock
UBP	# Urstadt Biddle Properties Inc. Common Stock
UBP$F	# Urstadt Biddle Properties Inc. Pfd Ser F
UBP$G	# Urstadt Biddle Properties Inc. Preferred Stock Series G 6.75%
UBS	# UBS Group AG Registered Ordinary Shares
UBS$D	# UBS AG Trust Preferred Securities
UCP	# "UCP
UDR	# "UDR
UE.V	# Urban Edge Properties Common Shares of Beneficial Interest When Issued
UFI	# "Unifi
UFS	# Domtar Corporation (NEW) Common Stock
UGI	# UGI Corporation Common Stock
UGP	# Ultrapar Participacoes S.A. (New) American Depositary Shares (Each representing one Common Share)
UHS	# "Universal Health Services
UHT	# Universal Health Realty Income Trust Common Stock
UIL	# UIL Holdings Corporation Common Stock
UIS	# Unisys Corporation New Common Stock
UL	# Unilever PLC Common Stock
UMC	# United Microelectronics Corporation (NEW) Common Stock
UMH	# "UMH Properties
UMH$A	# "UMH Properties
UN	# Unilever NV Common Stock
UNF	# Unifirst Corporation Common Stock
UNH	# UnitedHealth Group Incorporated Common Stock
UNM	# Unum Group Common Stock
UNP	# Union Pacific Corporation Common Stock
UNT	# Unit Corporation Common Stock
UPL	# Ultra Petroleum Corp. Common Stock
UPS	# "United Parcel Service
URI	# "United Rentals
USA	# Liberty All
USAC	# "USA Compression Partners
USB	# U.S. Bancorp Common Stock
USB$A	# "U.S. Bancorp Depositary Shares
USB$H	# U.S. Bancorp Depositary Shares repstg 1/1000th Pfd Ser B
USB$M	# U.S. Bancorp Depositary Shares Representing 1/1000th Interest in a Shares Series F
USB$N	# US Bancorp Del DEPOSITARY SH S G
USB$O	# US Bancorp Del Dep Shs Repstg 1/1000th Perp Pfd Ser H
USDP	# USD Partners LP Common Units representing limited partner interest
USG	# USG Corporation Common Stock
USM	# United States Cellular Corporation Common Stock
USNA	# "USANA Health Sciences
USPH	# "U.S. Physical Therapy
UTF	# "Cohen & Steers Infrastructure Fund
UTI	# Universal Technical Institute Inc Common Stock
UTL	# UNITIL Corporation Common Stock
UTX	# United Technologies Corporation Common Stock
UTX$A	# United Technologies Corp Corp Unit
UVE	# UNIVERSAL INSURANCE HOLDINGS INC Common Stock
UVV	# Universal Corporation Common Stock
UZA	# United States Cellular Corporation 6.95% Senior Notes due 2060
UZB	# United States Cellular Corporation 7.25% Senior Notes due 2063
V	# Visa Inc.
VAC	# Marriot Vacations Worldwide Corporation Common Stock
VAL	# Valspar Corporation (The) Common Stock
VALE	# VALE S.A.  American Depositary Shares Each Representing one common share
VALE.P	# VALE S.A.
VAR	# "Varian Medical Systems
VBF	# Invesco Bond Fund Common Stock
VC	# Visteon Corporation Common Stock
VCO	# Vina Concha Y Toro Common Stock
VCRA	# "Vocera Communications
VCV	# Invesco California Value Municipal Income Trust Common Stock
VEC	# "Vectrus
VEEV	# Veeva Systems Inc. Class A Common Stock
VET	# Vermilion Energy Inc. Common (Canada)
VFC	# V.F. Corporation Common Stock
VG	# Vonage Holdings Corp. Common Stock
VGI	# Virtus Global Multi
VGM	# Invesco Trust for Investment Grade Municipals Common Stock (DE)
VGR	# Vector Group Ltd. Common Stock
VHI	# "Valhi
VIPS	# "Vipshop Holdings Limited American Depositary Shares
VIV	# "Telefonica Brasil
VJET	# "voxeljet AG American Depositary Shares
VKQ	# Invesco Municipal Trust Common Stock
VLO	# Valero Energy Corporation Common Stock
VLP	# Valero Energy Partners LP Common Units representing limited partner interests
VLRS	# "Controladora Vuela Compania de Aviacion
VLT	# Invesco High Income Trust II
VLY	# Valley National Bancorp Common Stock
VLY.W	# Valley National Bancorp Warrants Expiring 11/14/2018
VMC	# Vulcan Materials Company (Holding Company) Common Stock
VMEM	# "Violin Memory
VMI	# "Valmont Industries
VMO	# Invesco Municipal Opportunity Trust Common Stock
VMW	# "Vmware
VNCE	# Vince Holding Corp. Common Stock
VNO	# Vornado Realty Trust Common Stock
VNO$G	# Vornado Realty Trust Preferred Series G
VNO$I	# Vornado Realty Trust Preferred Series I
VNO$J	# Vornado Realty Trust PFD CUMULATIVE RED SER J %
VNO$K	# Vornado Realty Trust Pfd S K
VNO$L	# Vornado Realty Trust Pfd Ser L %
VNO.V	# Vornado Realty Trust Common Shares of Beneficial Interest Ex
VNTV	# "Vantiv
VOC	# VOC Energy Trust Units of Beneficial Interest
VOYA	# "Voya Financial
VPG	# "Vishay Precision Group
VPV	# Invesco Pennsylvania Value Municipal Income Trust Common Stock (DE)
VR	# "Validus Holdings
VRS	# Verso Corporation Common Stock
VRTV	# Veritiv Corporation Common Stock
VRX	# "Valeant Pharmaceuticals International
VSH	# "Vishay Intertechnology
VSI	# "Vitamin Shoppe
VSLR	# "Vivint Solar
VTA	# Invesco Credit Opportunities Fund Common Shares of Beneficial Interest
VTN	# Invesco Trust for Investment Grade New York Municipals Common Stock
VTR	# "Ventas
VTRB	# "Ventas Realty
VTTI	# VTTI Energy Partners LP Common Units representing limited partner interests
VVC	# Vectren Corporation Common Stock
VVI	# Viad Corp Common Stock
VVR	# Invesco Senior Income Trust Common Stock (DE)
VZ	# Verizon Communications Inc. Common Stock
VZA	# Verizon Communications Inc. 5.90% Notes due 2054
W	# Wayfair Inc. Class A Common Stock
WAB	# Westinghouse Air Brake Technologies Corporation Common Stock
WAC	# Walter Investment Management Corp. Common Stock
WAGE	# "WageWorks
WAIR	# "Wesco Aircraft Holdings
WAL	# Western Alliance Bancorporation Common Stock (DE)
WAT	# Waters Corporation Common Stock
WBAI	# "500.com Limited American Depositary Shares
WBC	# Wabco Holdings Inc. Common Stock
WBK	# Westpac Banking Corporation Common Stock
WBS	# Webster Financial Corporation Common Stock
WBS$E	# Webster Financial Corporation Dep Shs Repstg 1/1000th Perp Pfd Ser E
WBS.W	# "Webster Financial Corporation Warrant (expiring November 21
WCC	# "WESCO International
WCG	# "Wellcare Health Plans
WCIC	# "WCI Communities
WCN	# "Waste Connections
WD	# "Walker & Dunlop
WDAY	# "Workday
WDR	# "Waddell & Reed Financial
WEA	# Western Asset Bond Fund Share of Beneficial Interest
WEC	# Wisconsin Energy Corporation Common Stock
WES	# "Western Gas Partners
WEX	# WEX Inc. common stock
WF	# Woori Bank American Depositary Shares (Each representing 3 shares of Common Stock)
WFC	# Wells Fargo & Company Common Stock
WFC$J	# Wells Fargo & Company Wells Fargo & Company 8.00% Non
WFC$L	# Wells Fargo & Company Wells Fargo & Company 7.50% Non
WFC$N	# Wells Fargo & Company Dep Shs Repstg 1/1000th Perp Pfd Cl A Ser N
WFC$O	# Wells Fargo & Company Depositary Shares Representing 1/1000th Perpetual Preferred Class A Series O
WFC$P	# Wells Fargo & Company Dep Shs Repstg 1/1000th Int Non Cum Perp Cl A Pfd (Ser P)
WFC$Q	# Wells Fargo & Company Depositary Shares Representing 1/1000th Interest Perpetual Preferred Class A Series Q Fixed to Floating
WFC$R	# Wells Fargo & Company Dep Shs Repstg 1/1000th Int Perp Pfd Cl A (Ser R Fixed To Flltg)
WFC$T	# Wells Fargo & Company New Depository Share Representing 1/1000th Perp. Preferred Class A Series T
WFC.W	# "Wells Fargo & Company Warrants expiring October 28
WFE$A	# "Wells Fargo & Company Cumulative Perpetual Preferred Stock
WFT	# Weatherford International plc (Ireland)
WG	# "Willbros Group
WGL	# WGL Holdings IncCommon Stock
WGO	# "Winnebago Industries
WGP	# "Western Gas Equity Partners
WHG	# Westwood Holdings Group Inc Common Stock
WHR	# Whirlpool Corporation Common Stock
WHX	# Whiting USA Trust I Whiting USA Trust I
WHZ	# Whiting USA Trust II Units of Beneficial Interest
WIA	# Western Asset/Claymore Inflation
WIT	# Wipro Limited Common Stock
WIW	# Western Asset/Claymore Inflation
WK	# Workiva Inc. Class A Common Stock
WLH	# Lyon William Homes Common Stock (Class A)
WLK	# Westlake Chemical Corporation Common Stock
WLKP	# Westlake Chemical Partners LP Common Units representing limited partner interests
WLL	# Whiting Petroleum Corporation Common Stock
WLT	# "Walter Energy
WM	# "Waste Management
WMB	# "Williams Companies
WMC	# Western Asset Mortgage Capital Corporation Common Stock
WMK	# "Weis Markets
WMLP	# "Westmoreland Resource Partners
WMS	# "Advanced Drainage Systems
WMT	# Wal
WNC	# Wabash National Corporation Common Stock
WNR	# "Western Refining Inc. Western Refining
WNRL	# "Western Refining Logistics
WNS	# WNS (Holdings) Limited Sponsored ADR (Jersey)
WOR	# "Worthington Industries
WPC	# W.P. Carey Inc. REIT
WPG	# Washington Prime Group Inc. Common Stock
WPP	# Wausau Paper Corp. Common Stock
WPT	# "World Point Terminals
WPX	# "WPX Energy
WPZ	# Williams Partners L.P. Common Units
WR	# "Westar Energy
WRB	# W.R. Berkley Corporation Common Stock
WRB$B	# W.R. Berkley Corporation 5.625% Subordinated Debentures due 2053
WRE	# Washington Real Estate Investment Trust Common Stock
WRI	# Weingarten Realty Investors Common Stock
WRI$F	# Weingarten Realty Investors Depository Shares Restg 1/100 Pfd Ser F
WRT	# Winthrop Realty Trust 7.75% Senior Notes due 2022
WSH	# Willis Group Holdings Public Limited (Ireland) Common Stock
WSM	# Williams
WSO	# "Watsco
WSO.B	# "Watsco
WSR	# Whitestone REIT Common Shares
WST	# "West Pharmaceutical Services
WTI	# "W&T Offshore
WTM	# "White Mountains Insurance Group
WTR	# "Aqua America
WTS	# "Watts Water Technologies
WTW	# Weight Watchers International Inc Weight Watchers International Inc
WU	# Western Union Company (The) Common Stock
WUBA	# "58.com Inc. American Depositary Shares
WWAV	# Whitewave Foods Company (The) Common Stock
WWE	# "World Wrestling Entertainment
WWW	# "Wolverine World Wide
WX	# WuXi PharmaTech (Cayman) Inc. American Depositary Shares
WY	# Weyerhaeuser Company Common Stock
WY$A	# Weyerhaeuser Company Pref Conv Ser A
WYN	# Wyndham Worldwide Corp Common  Stock
X	# United States Steel Corporation Common Stock
XCO	# "EXCO Resources
XEC	# Cimarex Energy Co Common Stock
XEL	# Xcel Energy Inc. Common Stock
XIN	# Xinyuan Real Estate Co Ltd American Depositary Shares
XKE	# Lehman ABS Corporation Corporate
XL	# XL Group plc
XLS	# Exelis Inc. Common Stock New
XNY	# "China Xiniya Fashion Limited American Depositary Shares
XOM	# Exxon Mobil Corporation Common Stock
XON	# Intrexon Corporation Common Stock
XOXO	# "XO Group
XPO	# "XPO Logistics
XRM	# "Xerium Technologies
XRS	# "TAL Education Group American Depositary Shares
XRX	# Xerox Corporation Common Stock
XUE	# "Xueda Education Group American Depositary Shares
XYL	# Xylem Inc. Common Stock New
Y	# Alleghany Corporation Common Stock
YDKN	# Yadkin Financial Corporation Common Stock
YELP	# Yelp Inc. Class A Common Stock
YGE	# Yingli Green Energy Holding Company Limited ADR
YOKU	# "Youku Tudou Inc. American Depositary Shares
YPF	# YPF Sociedad Anonima Common Stock
YUM	# "Yum! Brands
YUME	# "YuMe
YZC	# Yanzhou Coal Mining Company Limited Common Stock
ZA	# Zuoan Fashion Limited American Depositary Shares
ZAYO	# "Zayo Group Holdings
ZB$A	# Zions Bancorporation Depositary Shares (Each representing 1/40th Interest in a Share of Series A Floating
ZB$F	# Zions Bancorporation Dep shs Repstg 1/40th Int Sh Ser F Fxd Rate Non Cum (Perp Pfd Stk)
ZB$G	# Zions Bancorporation Dep Shs Repstg 1/40th Perp Pfd Ser G
ZB$H	# Zions Bancorporation Dep Shs Repstg 1/40th Int Sh Ser H Perp Pfd Stk
ZBK	# Zions Bancorporation 6.95% Fixed
ZEN	# "Zendesk
ZEP	# Zep Inc. Common Stock
ZF	# "Zweig Fund
ZFC	# ZAIS Financial Corp. Common Stock
ZMH	# "Zimmer Holdings
ZNH	# China Southern Airlines Company Limited Common Stock
ZOES	# "Zoe's Kitchen
ZPIN	# "Zhaopin Limited American Depositary Shares
ZQK	# "Quiksilver
ZTR	# "Zweig Total Return Fund
ZTS	# Zoetis Inc. Class A Common Stock
ZX	# "China Zenix Auto International Limited American Depositary Shares
